あいあいしい	あいあいしい
あいきょうらしい	あいきょうらしい
あいくるしい	あいくるしい
あいだてない	あいだてない
あいひとしい	あいひとしい
あいらしい	あいらしい
あえない	あえない
あおい	あおい
あおくさい	あおくさい
あおぐろい	あおぐろい
あおじろい	あおじろい
あおっぽい	あおっぽい
あかい	あかい
あかぐろい	あかぐろい
あかるい	あかるい
あきっぽい	あきっぽい
あきやすい	あきやすい
あくどい	あくどい
あけしい	あけしい
あけやすい	あけやすい
あさあさしい	あさあさしい
あさい	あさい
あさぐろい	あさぐろい
あさましい	あさましい
あざとい	あざとい
あしい	あしい
あしちかい	あしちかい
あしぢかい	あしぢかい
あじきない	あじきない
あじけない	あじけない
あじない	あじない
あじゃらしい	あじゃらしい
あじわいぶかい	あじわいぶかい
あせくさい	あせくさい
あたじけない	あたじけない
あたたかい	あたたかい
あたたしい	あたたしい
あたらしい	あたらしい
あだっぽい	あだっぽい
あだない	あだない
あっけない	あっけない
あったかい	あったかい
あったぼこしゅもない	あったぼこしゅもない
あつい	あつい
あつかましい	あつかましい
あつくるしい	あつくるしい
あつぼったい	あつぼったい
あてつけがましい	あてつけがましい
あとかたない	あとかたない
あどけない	あどけない
あどない	あどない
あぶない	あぶない
あぶなげない	あぶなげない
あぶなっかしい	あぶなっかしい
あぶらっこい	あぶらっこい
あほうくさい	あほうくさい
あほくさい	あほくさい
あほらしい	あほらしい
あまい	あまい
あまからい	あまからい
あまじょっぱい	あまじょっぱい
あまずっぱい	あまずっぱい
あまたるい	あまたるい
あまちこい	あまちこい
あまちょろい	あまちょろい
あまったるい	あまったるい
あまっちょろい	あまっちょろい
あやうい	あやうい
あやしい	あやしい
あらあらしい	あらあらしい
あらい	あらい
あらくもしい	あらくもしい
あらけない	あらけない
あらっぽい	あらっぽい
あられもない	あられもない
ありがたい	ありがたい
あわあわしい	あわあわしい
あわい	あわい
あわただしい	あわただしい
あわよい	あわよい
あわれっぽい	あわれっぽい
あわれみぶかい	あわれみぶかい
いい	いい
いいがたい	いいがたい
いいにくい	いいにくい
いかい	いかい
いかがしい	いかがしい
いかがわしい	いかがわしい
いかつい	いかつい
いかめい	いかめい
いかめしい	いかめしい
いがらっぽい	いがらっぽい
いきぐるしい	いきぐるしい
いきだわしい	いきだわしい
いきどおろしい	いきどおろしい
いぎたない	いぎたない
いぎぶかい	いぎぶかい
いくひさしい	いくひさしい
いぐるしい	いぐるしい
いけずうずうしい	いけずうずうしい
いけ図図しい	いけ図図しい
いげちない	いげちない
いさぎよい	いさぎよい
いさましい	いさましい
いざとい	いざとい
いしこらしい	いしこらしい
いじきたない	いじきたない
いじくねわるい	いじくねわるい
いじましい	いじましい
いじらしい	いじらしい
いじわるい	いじわるい
いそいそしい	いそいそしい
いそがしい	いそがしい
いそがわしい	いそがわしい
いそくさい	いそくさい
いたい	いたい
いたいけない	いたいけない
いたいたしい	いたいたしい
いたがゆい	いたがゆい
いたきもちいい	いたきもちいい
いたましい	いたましい
いたわしい	いたわしい
いちじるしい	いちじるしい
いっかい	いっかい
いづらい	いづらい
いとおしい	いとおしい
いとけない	いとけない
いとしい	いとしい
いとしぼい	いとしぼい
いとしらしい	いとしらしい
いとわしい	いとわしい
いなかくさい	いなかくさい
いぶかしい	いぶかしい
いぶせい	いぶせい
いまいましい	いまいましい
いまさららしい	いまさららしい
いまめかしい	いまめかしい
いまわしい	いまわしい
いやしい	いやしい
いやみたらしい	いやみたらしい
いやらしい	いやらしい
いらいらしい	いらいらしい
いらだたしい	いらだたしい
いらひどい	いらひどい
いろっぽい	いろっぽい
いろよい	いろよい
いわけない	いわけない
いわれない	いわれない
いんきくさい	いんきくさい
いんしょうぶかい	いんしょうぶかい
うい	うい
ういういしい	ういういしい
うさんくさい	うさんくさい
うさんらしい	うさんらしい
うざい	うざい
うざっこい	うざっこい
うざったい	うざったい
うしろぎたない	うしろぎたない
うしろぐらい	うしろぐらい
うしろめたい	うしろめたい
うすあかるい	うすあかるい
うすあまい	うすあまい
うすい	うすい
うすきみわるい	うすきみわるい
うすぎたない	うすぎたない
うすぐらい	うすぐらい
うすぐろい	うすぐろい
うすさびしい	うすさびしい
うすさむい	うすさむい
うすざむい	うすざむい
うすじろい	うすじろい
うすのろい	うすのろい
うすべったい	うすべったい
うすらさむい	うすらさむい
うずたかい	うずたかい
うそあまい	うそあまい
うそさびしい	うそさびしい
うそさむい	うそさむい
うそっぽい	うそっぽい
うそはずかしい	うそはずかしい
うそ寂しい	うそ寂しい
うそ寒い	うそ寒い
うそ恥ずかしい	うそ恥ずかしい
うそ甘い	うそ甘い
うたがいない	うたがいない
うたがいぶかい	うたがいぶかい
うたがわしい	うたがわしい
うたぐりぶかい	うたぐりぶかい
うたれづよい	うたれづよい
うたれよわい	うたれよわい
うだうだしい	うだうだしい
うっつい	うっつい
うっとうしい	うっとうしい
うつくしい	うつくしい
うとい	うとい
うとうとしい	うとうとしい
うとましい	うとましい
うぶい	うぶい
うまい	うまい
うまうましい	うまうましい
うやうやしい	うやうやしい
うらがなしい	うらがなしい
うらさびしい	うらさびしい
うらはずかしい	うらはずかしい
うらみがましい	うらみがましい
うらめしい	うらめしい
うらやましい	うらやましい
うらわかい	うらわかい
うら若い	うら若い
うるさい	うるさい
うるわしい	うるわしい
うれしい	うれしい
うれしがなしい	うれしがなしい
うれわしい	うれわしい
えい	えい
ええ	ええ
えがたい	えがたい
えがらい	えがらい
えがらっぽい	えがらっぽい
えぐい	えぐい
えげつない	えげつない
えごい	えごい
えずい	えずい
えらい	えらい
えんどおい	えんどおい
えんりょぶかい	えんりょぶかい
おいしい	おいしい
おえない	おえない
おおい	おおい
おおかり	おおかり
おおきい	おおきい
おおしい	おおしい
おおずけない	おおずけない
おかしい	おかしい
おかしがたい	おかしがたい
おかったるい	おかったるい
おくふかい	おくふかい
おくぶかい	おくぶかい
おくゆかしい	おくゆかしい
おぐらい	おぐらい
おこがましい	おこがましい
おこりっぽい	おこりっぽい
おさあい	おさあい
おさない	おさない
おさならしい	おさならしい
おさむい	おさむい
おしい	おしい
おしつけがましい	おしつけがましい
おしづよい	おしづよい
おしみない	おしみない
おしろいくさい	おしろいくさい
おそい	おそい
おそれおおい	おそれおおい
おそろしい	おそろしい
おぞい	おぞい
おぞましい	おぞましい
おたかい	おたかい
おっかない	おっかない
おっきい	おっきい
おとこくさい	おとこくさい
おとこらしい	おとこらしい
おとなげない	おとなげない
おとなしい	おとなしい
おとなっぽい	おとなっぽい
おどろおどろしい	おどろおどろしい
おなごらしい	おなごらしい
おなじい	おなじい
おにおにしい	おにおにしい
おびただしい	おびただしい
おぼこい	おぼこい
おぼしい	おぼしい
おぼつかない	おぼつかない
おめでたい	おめでたい
おもい	おもい
おもいがけない	おもいがけない
おもいでぶかい	おもいでぶかい
おもおもしい	おもおもしい
おもくるしい	おもくるしい
おもくろい	おもくろい
おもくろしい	おもくろしい
おもしろい	おもしろい
おもしろおかしい	おもしろおかしい
おもたい	おもたい
おもったるい	おもったるい
おもはゆい	おもはゆい
おもろい	おもろい
おもわしい	おもわしい
おやげない	おやげない
おやすい	おやすい
おやみない	おやみない
およびがたい	およびがたい
おりめただしい	おりめただしい
おろかしい	おろかしい
おんがましい	おんがましい
おんきせがましい	おんきせがましい
おんなくさい	おんなくさい
おんならしい	おんならしい
お安い	お安い
かいい	かいい
かいがいしい	かいがいしい
かいだるい	かいだるい
かいない	かいない
かがやかしい	かがやかしい
かぎりない	かぎりない
かくい	かくい
かくれない	かくれない
かぐろい	かぐろい
かぐわしい	かぐわしい
かごとがましい	かごとがましい
かさだかい	かさだかい
かしがましい	かしがましい
かしこい	かしこい
かしましい	かしましい
かたい	かたい
かたくるしい	かたくるしい
かたくろしい	かたくろしい
かたじけない	かたじけない
かたはらいたい	かたはらいたい
かっこいい	かっこいい
かっこわるい	かっこわるい
かっこ好い	かっこ好い
かっこ悪い	かっこ悪い
かったるい	かったるい
かってがましい	かってがましい
かどかどしい	かどかどしい
かなくさい	かなくさい
かなしい	かなしい
かびくさい	かびくさい
かぼそい	かぼそい
かまびすしい	かまびすしい
かゆい	かゆい
かよわい	かよわい
からい	からい
かるい	かるい
かるがるしい	かるがるしい
かろい	かろい
かろがろしい	かろがろしい
かわいい	かわいい
かわいらしい	かわいらしい
かわゆい	かわゆい
かわゆらしい	かわゆらしい
かんがいぶかい	かんがいぶかい
かんがえぶかい	かんがえぶかい
かんこくさい	かんこくさい
かんじやすい	かんじやすい
かんじょうだかい	かんじょうだかい
かんだかい	かんだかい
かんばしい	かんばしい
かんべんづよい	かんべんづよい
か弱い	か弱い
か細い	か細い
か黒い	か黒い
がづよい	がづよい
がまんづよい	がまんづよい
がめつい	がめつい
がんぜない	がんぜない
きいろい	きいろい
きがるい	きがるい
ききぐるしい	ききぐるしい
ききづらい	ききづらい
ききともない	ききともない
ききにくい	ききにくい
ききよい	ききよい
きざったらしい	きざったらしい
きざっぽい	きざっぽい
きしがたい	きしがたい
きしょい	きしょい
きじゅつない	きじゅつない
きぜわしい	きぜわしい
きぜわしない	きぜわしない
きそくただしい	きそくただしい
きたない	きたない
きたならしい	きたならしい
きつい	きつい
きづかわしい	きづかわしい
きづよい	きづよい
きながい	きながい
きなくさい	きなくさい
きな臭い	きな臭い
きはずかしい	きはずかしい
きばやい	きばやい
きびしい	きびしい
きびよい	きびよい
きびわるい	きびわるい
きぶい	きぶい
きぶとい	きぶとい
きぼそい	きぼそい
きまずい	きまずい
きまりわるい	きまりわるい
きみよい	きみよい
きみわるい	きみわるい
きむずかしい	きむずかしい
きめこまかい	きめこまかい
きもい	きもい
きもかわいい	きもかわいい
きもちいい	きもちいい
きもちよい	きもちよい
きもちわるい	きもちわるい
きも可愛い	きも可愛い
きやすい	きやすい
きょうとい	きょうとい
きょうみぶかい	きょうみぶかい
きょとい	きょとい
きよい	きよい
きよわい	きよわい
きらきらしい	きらきらしい
きわどい	きわどい
きわまりない	きわまりない
ぎこちない	ぎこちない
ぎこつない	ぎこつない
ぎづよい	ぎづよい
ぎょうぎただしい	ぎょうぎただしい
ぎょうぎづよい	ぎょうぎづよい
ぎょうぎょうしい	ぎょうぎょうしい
ぎょしがたい	ぎょしがたい
ぎょしやすい	ぎょしやすい
ぎりがたい	ぎりがたい
ぎりぎりしい	ぎりぎりしい
ぎりづよい	ぎりづよい
くさい	くさい
くさぶかい	くさぶかい
くすぐったい	くすぐったい
くぜつがましい	くぜつがましい
くだくだしい	くだくだしい
くちい	くちい
くちうるさい	くちうるさい
くちおしい	くちおしい
くちおもい	くちおもい
くちがしこい	くちがしこい
くちがたい	くちがたい
くちがるい	くちがるい
くちぎたない	くちぎたない
くちさがない	くちさがない
くちさびしい	くちさびしい
くちざみしい	くちざみしい
くちぢかい	くちぢかい
くちはばたい	くちはばたい
くちはばったい	くちはばったい
くちひろい	くちひろい
くちやかましい	くちやかましい
くったくない	くったくない
くどい	くどい
くどくどしい	くどくどしい
くぼい	くぼい
くみしやすい	くみしやすい
くやしい	くやしい
くらい	くらい
くるおしい	くるおしい
くるしい	くるしい
くるわしい	くるわしい
くれやすい	くれやすい
くろい	くろい
くろっぽい	くろっぽい
くわしい	くわしい
ぐちっぽい	ぐちっぽい
けいげいしい	けいげいしい
けいさんだかい	けいさんだかい
けいはくらしい	けいはくらしい
けうとい	けうとい
けがらわしい	けがらわしい
けたたましい	けたたましい
けだかい	けだかい
けだるい	けだるい
けちくさい	けちくさい
けちぶとい	けちぶとい
けち太い	けち太い
けち臭い	けち臭い
けったるい	けったるい
けどおい	けどおい
けなりい	けなりい
けなるい	けなるい
けばい	けばい
けばけばしい	けばけばしい
けぶい	けぶい
けぶかい	けぶかい
けぶさい	けぶさい
けぶたい	けぶたい
けむい	けむい
けむたい	けむたい
けむったい	けむったい
けわしい	けわしい
けんかっぱやい	けんかっぱやい
けんかばやい	けんかばやい
けんだかい	けんだかい
げすい	げすい
こあまい	こあまい
こい	こい
こいしい	こいしい
こうごうしい	こうごうしい
こうばしい	こうばしい
こうるさい	こうるさい
こきみよい	こきみよい
こきみわるい	こきみわるい
こぎたない	こぎたない
こぐらい	こぐらい
こげくさい	こげくさい
ここちよい	ここちよい
こころうれしい	こころうれしい
こころおきない	こころおきない
こころおもしろい	こころおもしろい
こころぐるしい	こころぐるしい
こころさびしい	こころさびしい
こころさみしい	こころさみしい
こころざむい	こころざむい
こころぜわしい	こころぜわしい
こころづよい	こころづよい
こころない	こころない
こころにくい	こころにくい
こころぼそい	こころぼそい
こころもとない	こころもとない
こころやさしい	こころやさしい
こころやすい	こころやすい
こころやましい	こころやましい
こころよい	こころよい
こころよわい	こころよわい
こころわるい	こころわるい
こさびしい	こさびしい
こさむい	こさむい
こざかしい	こざかしい
こしがるい	こしがるい
こじたたるい	こじたたるい
こじれったい	こじれったい
こすい	こすい
こすからい	こすからい
こすっからい	こすっからい
こずるい	こずるい
こぜわしい	こぜわしい
こそぐったい	こそぐったい
こそっぱい	こそっぱい
こそばい	こそばい
こそばゆい	こそばゆい
こだかい	こだかい
こっぱずかしい	こっぱずかしい
こっぴどい	こっぴどい
こっ酷い	こっ酷い
こつい	こつい
こづらにくい	こづらにくい
ことあたらしい	ことあたらしい
ことこまかい	ことこまかい
ことごとしい	ことごとしい
こどもっぽい	こどもっぽい
こどもらしい	こどもらしい
こながい	こながい
こにくい	こにくい
こにくらしい	こにくらしい
このましい	このましい
このもしい	このもしい
こはずかしい	こはずかしい
こばやい	こばやい
こぶい	こぶい
こぶかい	こぶかい
こまい	こまい
こまかい	こまかい
こまかしい	こまかしい
こまごましい	こまごましい
こみじかい	こみじかい
こむずかしい	こむずかしい
こむつかしい	こむつかしい
こむやくしい	こむやくしい
こやかましい	こやかましい
こやすい	こやすい
こゆい	こゆい
こよない	こよない
こわい	こわい
こわらしい	こわらしい
ござない	ござない
ごたいそうらしい	ごたいそうらしい
ごっつい	ごっつい
ごつい	ごつい
さいそくがましい	さいそくがましい
さえざえしい	さえざえしい
さかしい	さかしい
さがない	さがない
さくい	さくい
さけくさい	さけくさい
さしつかえない	さしつかえない
さしでがましい	さしでがましい
さだめない	さだめない
さとい	さとい
さびしい	さびしい
さぶい	さぶい
さみしい	さみしい
さむい	さむい
さむざむしい	さむざむしい
さむしい	さむしい
さもしい	さもしい
さりがたい	さりがたい
さりげない	さりげない
さるがしこい	さるがしこい
さわがしい	さわがしい
ざっかけない	ざっかけない
ざんない	ざんない
しおからい	しおからい
しおはゆい	しおはゆい
しおらしい	しおらしい
しかくい	しかくい
しかたない	しかたない
しかつべらしい	しかつべらしい
しかつめらしい	しかつめらしい
しがない	しがない
しけくさい	しけくさい
しけっぽい	しけっぽい
しげい	しげい
しげない	しげない
しさいらしい	しさいらしい
したしい	したしい
したしみぶかい	したしみぶかい
したたるい	したたるい
したわしい	したわしい
しだらない	しだらない
しちくどい	しちくどい
しちむずかしい	しちむずかしい
しちめんどうくさい	しちめんどうくさい
しち難しい	しち難しい
しち面倒臭い	しち面倒臭い
しっとぶかい	しっとぶかい
しつこい	しつこい
しつっこい	しつっこい
しつぶかい	しつぶかい
しどけない	しどけない
しどない	しどない
しにくい	しにくい
しのびがたい	しのびがたい
しのびない	しのびない
しぶい	しぶい
しぶとい	しぶとい
しめっぽい	しめっぽい
しゃちらごわい	しゃちらごわい
しゃまだるい	しゃまだるい
しゃらくさい	しゃらくさい
しゃ間怠い	しゃ間怠い
しゅうねい	しゅうねい
しゅうねんぶかい	しゅうねんぶかい
しょうことない	しょうことない
しょうしい	しょうしい
しょうぶづよい	しょうぶづよい
しょうべんくさい	しょうべんくさい
しょうらかしい	しょうらかしい
しょう事無い	しょう事無い
しょざいない	しょざいない
しょだいない	しょだいない
しょっぱい	しょっぱい
しょぼい	しょぼい
しょぼくない	しょぼくない
しょむずかしい	しょむずかしい
しょ難しい	しょ難しい
しらじらしい	しらじらしい
しりこそばゆい	しりこそばゆい
しりょぶかい	しりょぶかい
しるい	しるい
しろい	しろい
しろうとくさい	しろうとくさい
しろっぽい	しろっぽい
しわい	しわい
しんきくさい	しんきくさい
しんじんぶかい	しんじんぶかい
しんどい	しんどい
しんぼうづよい	しんぼうづよい
しんろい	しんろい
じじむさい	じじむさい
じちらしい	じちらしい
じひぶかい	じひぶかい
じまんくさい	じまんくさい
じまんたらしい	じまんたらしい
じゃすいぶかい	じゃすいぶかい
じゃまくさい	じゃまくさい
じゅくしくさい	じゅくしくさい
じゅつない	じゅつない
じゆうがましい	じゆうがましい
じょさいない	じょさいない
じれったい	じれったい
じんていらしい	じんていらしい
じんぶつらしい	じんぶつらしい
すい	すい
すいたらしい	すいたらしい
すえおそろしい	すえおそろしい
すえくさい	すえくさい
すえたのもしい	すえたのもしい
すかんたらしい	すかんたらしい
すがしい	すがしい
すがすがしい	すがすがしい
すくいがたい	すくいがたい
すくない	すくない
すけない	すけない
すけべえったらしい	すけべえったらしい
すげない	すげない
すこい	すこい
すごい	すごい
すさまじい	すさまじい
すじない	すじない
すじめただしい	すじめただしい
すすどい	すすどい
すずしい	すずしい
すっぱい	すっぱい
すなつかしい	すなつかしい
すねい	すねい
すねくろしい	すねくろしい
すばしこい	すばしこい
すばしっこい	すばしっこい
すばやい	すばやい
すばらしい	すばらしい
すべこい	すべこい
すべっこい	すべっこい
すみうい	すみうい
するどい	するどい
ずうずうしい	ずうずうしい
ずつない	ずつない
ずない	ずない
ずぶとい	ずぶとい
ずるい	ずるい
ずるがしこい	ずるがしこい
せからしい	せからしい
せぐるしい	せぐるしい
せこい	せこい
せせかましい	せせかましい
せせこましい	せせこましい
せちがしこい	せちがしこい
せちがらい	せちがらい
せつい	せつい
せつない	せつない
せばい	せばい
せまい	せまい
せまくるしい	せまくるしい
せわしい	せわしい
せわしない	せわしない
せわせわしい	せわせわしい
せんかたない	せんかたない
せんすべない	せんすべない
せんない	せんない
ぜひない	ぜひない
そうがましい	そうがましい
そうぞうしい	そうぞうしい
そぐわしい	そぐわしい
そこがたい	そこがたい
そこきみわるい	そこきみわるい
そこさびしい	そこさびしい
そこさむい	そこさむい
そこはかとない	そこはかとない
そこふかい	そこふかい
そそかしい	そそかしい
そそくさい	そそくさい
そそっかしい	そそっかしい
そっけない	そっけない
そでない	そでない
そとなつかしい	そとなつかしい
そらおそろしい	そらおそろしい
そらぞらしい	そらぞらしい
そらはずかしい	そらはずかしい
そろばんだかい	そろばんだかい
そわそわしい	そわそわしい
ぞうさない	ぞうさない
ぞくっぽい	ぞくっぽい
ぞんじがけない	ぞんじがけない
たあいない	たあいない
たいせつない	たいせつない
たいそうらしい	たいそうらしい
たえがたい	たえがたい
たえまない	たえまない
たかい	たかい
たくましい	たくましい
たぐいない	たぐいない
たけだけしい	たけだけしい
たしからしい	たしからしい
たしない	たしない
ただしい	ただしい
たっとい	たっとい
たどたどしい	たどたどしい
たのしい	たのしい
たのみすくない	たのみすくない
たのもしい	たのもしい
たやすい	たやすい
たゆい	たゆい
たゆみない	たゆみない
たよりない	たよりない
たわいない	たわいない
たわい無い	たわい無い
だいじない	だいじない
だいだいしい	だいだいしい
ださい	ださい
ださかっこいい	ださかっこいい
ださかっこ好い	ださかっこ好い
ださかわいい	ださかわいい
ださ可愛い	ださ可愛い
だだっぴろい	だだっぴろい
だだっ広い	だだっ広い
だだびろい	だだびろい
だだ広い	だだ広い
だらしない	だらしない
だるい	だるい
だんない	だんない
ちいさい	ちいさい
ちいちゃい	ちいちゃい
ちかい	ちかい
ちかしい	ちかしい
ちからづよい	ちからづよい
ちからない	ちからない
ちくい	ちくい
ちくさい	ちくさい
ちさい	ちさい
ちちくさい	ちちくさい
ちっこい	ちっこい
ちっちゃい	ちっちゃい
ちなまぐさい	ちなまぐさい
ちゃいろい	ちゃいろい
ちゃくい	ちゃくい
ちゃっちい	ちゃっちい
ちゃっぽい	ちゃっぽい
ちゃらい	ちゃらい
ちゃんちゃらおかしい	ちゃんちゃらおかしい
ちゅういぶかい	ちゅういぶかい
ちょうちょうしい	ちょうちょうしい
ちょろい	ちょろい
つがもない	つがもない
つきともない	つきともない
つたない	つたない
つちくさい	つちくさい
つつがない	つつがない
つつしみぶかい	つつしみぶかい
つつましい	つつましい
つべたい	つべたい
つぼい	つぼい
つましい	つましい
つみぶかい	つみぶかい
つめたい	つめたい
つやっぽい	つやっぽい
つやつやしい	つやつやしい
つよい	つよい
つらあてがましい	つらあてがましい
つらい	つらい
つらにくい	つらにくい
つれない	つれない
てあつい	てあつい
てあらい	てあらい
ていたい	ていたい
てうすい	てうすい
ておもい	ておもい
てがたい	てがたい
てがるい	てがるい
てきない	てきない
てきびしい	てきびしい
てごわい	てごわい
てしぶい	てしぶい
てぜまい	てぜまい
てぢかい	てぢかい
てっとりばやい	てっとりばやい
てづよい	てづよい
てぬるい	てぬるい
てねばい	てねばい
てのろい	てのろい
てばしこい	てばしこい
てばてばしい	てばてばしい
てばやい	てばやい
てひどい	てひどい
てびろい	てびろい
てみじかい	てみじかい
てむさい	てむさい
てもちない	てもちない
てもちわるい	てもちわるい
てれくさい	てれくさい
てんこちない	てんこちない
てんこちもない	てんこちもない
でかい	でかい
でかばちない	でかばちない
でっかい	でっかい
でっかちない	でっかちない
でんない	でんない
とうかんない	とうかんない
とうとい	とうとい
とおい	とおい
とおどおしい	とおどおしい
とげとげしい	とげとげしい
ところせまい	ところせまい
とざまがましい	とざまがましい
としよりくさい	としよりくさい
としわかい	としわかい
とっけもない	とっけもない
とっつきにくい	とっつきにくい
とっつきやすい	とっつきやすい
とっぽい	とっぽい
とでもない	とでもない
とぼしい	とぼしい
ともしい	ともしい
とろい	とろい
とろくさい	とろくさい
とんじゃくない	とんじゃくない
とんでもない	とんでもない
どえらい	どえらい
どぎつい	どぎつい
どくどくしい	どくどくしい
どしがたい	どしがたい
どすあかい	どすあかい
どすぐろい	どすぐろい
どす赤い	どす赤い
どす黒い	どす黒い
どでかい	どでかい
どびつこい	どびつこい
どろくさい	どろくさい
どろぶかい	どろぶかい
どんくさい	どんくさい
ど偉い	ど偉い
ない	ない
ながい	ながい
ながたらしい	ながたらしい
ながったらしい	ながったらしい
ながっぽそい	ながっぽそい
ながながしい	ながながしい
ながほそい	ながほそい
なげかわしい	なげかわしい
なごりおしい	なごりおしい
なごりない	なごりない
なさけない	なさけない
なさけぶかい	なさけぶかい
なさけらしい	なさけらしい
なじみぶかい	なじみぶかい
なたてがましい	なたてがましい
なだかい	なだかい
なつかしい	なつかしい
なつこい	なつこい
なつっこい	なつっこい
なにげない	なにげない
なにごころない	なにごころない
なまあたたかい	なまあたたかい
なまあたらしい	なまあたらしい
なまあつい	なまあつい
なまぐさい	なまぐさい
なまじろい	なまじろい
なまずけない	なまずけない
なまっちょろい	なまっちょろい
なまっちろい	なまっちろい
なまながい	なまながい
なまなましい	なまなましい
なまぬるい	なまぬるい
なまめかしい	なまめかしい
なまやさしい	なまやさしい
なまわかい	なまわかい
なみだぐましい	なみだぐましい
なみだづよい	なみだづよい
なみだもろい	なみだもろい
なやましい	なやましい
ならびない	ならびない
なるい	なるい
なれなれしい	なれなれしい
にあわしい	にあわしい
にがい	にがい
にがっぽい	にがっぽい
にがにがしい	にがにがしい
にぎにぎしい	にぎにぎしい
にぎわしい	にぎわしい
にくい	にくい
にくたらしい	にくたらしい
にくてらしい	にくてらしい
にくにくしい	にくにくしい
にくらしい	にくらしい
にげない	にげない
にっくい	にっくい
にっこい	にっこい
につかわしい	につかわしい
につこらしい	につこらしい
にぶい	にぶい
にべない	にべない
にやこい	にやこい
にんげんくさい	にんげんくさい
にんげんらしい	にんげんらしい
にんたいづよい	にんたいづよい
ぬかみそくさい	ぬかみそくさい
ぬきがたい	ぬきがたい
ぬくい	ぬくい
ぬくとい	ぬくとい
ぬるい	ぬるい
ぬるまっこい	ぬるまっこい
ねがわしい	ねがわしい
ねぐさい	ねぐさい
ねぐるしい	ねぐるしい
ねごい	ねごい
ねざとい	ねざとい
ねたましい	ねたましい
ねだりがましい	ねだりがましい
ねだりくさい	ねだりくさい
ねちこい	ねちこい
ねちっこい	ねちっこい
ねったい	ねったい
ねつい	ねつい
ねつくさい	ねつくさい
ねつこい	ねつこい
ねつっこい	ねつっこい
ねつっぽい	ねつっぽい
ねづよい	ねづよい
ねばい	ねばい
ねばっこい	ねばっこい
ねばりづよい	ねばりづよい
ねぶかい	ねぶかい
ねぶたい	ねぶたい
ねむい	ねむい
ねむたい	ねむたい
のこりおおい	のこりおおい
のこりおしい	のこりおしい
のこりすくない	のこりすくない
のぞましい	のぞましい
のびろい	のびろい
のぶかい	のぶかい
のぶとい	のぶとい
のろい	のろい
のろくさい	のろくさい
のろわしい	のろわしい
はかない	はかない
はかばかしい	はかばかしい
はがいい	はがいい
はがゆい	はがゆい
はくい	はくい
はげしい	はげしい
はしかい	はしかい
はしこい	はしこい
はしたない	はしたない
はしぢかい	はしぢかい
はしっこい	はしっこい
はじがましい	はじがましい
はずい	はずい
はずかしい	はずかしい
はださびしい	はださびしい
はださむい	はださむい
はてしない	はてしない
はではでしい	はではでしい
はなはずかしい	はなはずかしい
はなはだしい	はなはだしい
はなばなしい	はなばなしい
はばったい	はばったい
はばひろい	はばひろい
はもじい	はもじい
はやい	はやい
はらぎたない	はらぎたない
はらぐろい	はらぐろい
はらだたしい	はらだたしい
はれがましい	はれがましい
はればれしい	はればれしい
はれぼったい	はれぼったい
はんかくさい	はんかくさい
はんぱない	はんぱない
は文字い	は文字い
ばかくさい	ばかくさい
ばかたかい	ばかたかい
ばかでかい	ばかでかい
ばかばかしい	ばかばかしい
ばからしい	ばからしい
ばっちい	ばっちい
ばばっちい	ばばっちい
ひがみっぽい	ひがみっぽい
ひくい	ひくい
ひさしい	ひさしい
ひすい	ひすい
ひだるい	ひだるい
ひちくどい	ひちくどい
ひちむずかしい	ひちむずかしい
ひち難しい	ひち難しい
ひっきりない	ひっきりない
ひつこい	ひつこい
ひとがましい	ひとがましい
ひとくさい	ひとくさい
ひとこいしい	ひとこいしい
ひとしい	ひとしい
ひとだかい	ひとだかい
ひとちかい	ひとちかい
ひととおい	ひととおい
ひとどおい	ひとどおい
ひとなつかしい	ひとなつかしい
ひとなつこい	ひとなつこい
ひとらしい	ひとらしい
ひとわるい	ひとわるい
ひどい	ひどい
ひなたくさい	ひなたくさい
ひねくさい	ひねくさい
ひもじい	ひもじい
ひやこい	ひやこい
ひやっこい	ひやっこい
ひょろながい	ひょろながい
ひょろ長い	ひょろ長い
ひよわい	ひよわい
ひらい	ひらい
ひらたい	ひらたい
ひらったい	ひらったい
ひらべったい	ひらべったい
ひろい	ひろい
ひ弱い	ひ弱い
びびしい	びびしい
びんぼうくさい	びんぼうくさい
びんぼうたらしい	びんぼうたらしい
ふかい	ふかい
ふかしい	ふかしい
ふがいない	ふがいない
ふくぶくしい	ふくぶくしい
ふさふさしい	ふさふさしい
ふさぶさしい	ふさぶさしい
ふさわしい	ふさわしい
ふてきない	ふてきない
ふてぶてしい	ふてぶてしい
ふてらっこい	ふてらっこい
ふとい	ふとい
ふるい	ふるい
ふるくさい	ふるくさい
ふるしい	ふるしい
ふるぶるしい	ふるぶるしい
ふるめかしい	ふるめかしい
ふんべつくさい	ふんべつくさい
ふんべつらしい	ふんべつらしい
ぶあつい	ぶあつい
ぶしょうったらしい	ぶしょうったらしい
へだてがましい	へだてがましい
へぼい	へぼい
へんない	へんない
ほいない	ほいない
ほおえましい	ほおえましい
ほこしもない	ほこしもない
ほこしゅもない	ほこしゅもない
ほこらしい	ほこらしい
ほこりたかい	ほこりたかい
ほこりっぽい	ほこりっぽい
ほしい	ほしい
ほそい	ほそい
ほそながい	ほそながい
ほてくろしい	ほてくろしい
ほとけくさい	ほとけくさい
ほどちかい	ほどちかい
ほどとおい	ほどとおい
ほどよい	ほどよい
ほねっぽい	ほねっぽい
ほのあかるい	ほのあかるい
ほのぐらい	ほのぐらい
ほのじろい	ほのじろい
ほほえましい	ほほえましい
ほれっぽい	ほれっぽい
ほろにがい	ほろにがい
ほろ苦い	ほろ苦い
ぼうずくさい	ぼうずくさい
ぼろい	ぼろい
ぼろっちい	ぼろっちい
まあたらしい	まあたらしい
まがまがしい	まがまがしい
まぎらわしい	まぎらわしい
まざまざしい	まざまざしい
ましろい	ましろい
まずい	まずい
まずしい	まずしい
またい	またい
またない	またない
まだるい	まだるい
まだるこい	まだるこい
まだるこしい	まだるこしい
まだるっこい	まだるっこい
まだるっこしい	まだるっこしい
まちどおい	まちどおい
まちどおしい	まちどおしい
まちわびしい	まちわびしい
まぢかい	まぢかい
まっくろい	まっくろい
まっこうくさい	まっこうくさい
まっしろい	まっしろい
まったい	まったい
まどおい	まどおい
まどろい	まどろい
まどろこい	まどろこい
まどろこしい	まどろこしい
まどろっこい	まどろっこい
まどろっこしい	まどろっこしい
まぬるい	まぬるい
まのろい	まのろい
まばゆい	まばゆい
まぶい	まぶい
まぶしい	まぶしい
まぼしい	まぼしい
まましい	まましい
まめまめしい	まめまめしい
まるい	まるい
まるっこい	まるっこい
まるまこい	まるまこい
まるまっこい	まるまっこい
まるまっちい	まるまっちい
まろい	まろい
まわりくどい	まわりくどい
まわりどおい	まわりどおい
まんべんない	まんべんない
まんまるい	まんまるい
みえにくい	みえにくい
みがるい	みがるい
みぐさい	みぐさい
みぐるしい	みぐるしい
みじかい	みじかい
みすぼらしい	みすぼらしい
みずくさい	みずくさい
みずっぽい	みずっぽい
みずみずしい	みずみずしい
みそごい	みそごい
みそぼらしい	みそぼらしい
みたむない	みたむない
みだりがましい	みだりがましい
みだりがわしい	みだりがわしい
みちれない	みちれない
みぢかい	みぢかい
みっともいい	みっともいい
みっともない	みっともない
みづらい	みづらい
みとうもない	みとうもない
みとむない	みとむない
みともない	みともない
みにくい	みにくい
みみあたらしい	みみあたらしい
みみぐるしい	みみぐるしい
みみざとい	みみざとい
みみっちい	みみっちい
みみどおい	みみどおい
みみばやい	みみばやい
みみめずらしい	みみめずらしい
みめうるわしい	みめうるわしい
みめよい	みめよい
みやすい	みやすい
みよい	みよい
みれんがましい	みれんがましい
みれんくさい	みれんくさい
みれんたらしい	みれんたらしい
むげちない	むげちない
むげつけない	むげつけない
むげない	むげない
むごい	むごい
むごたらしい	むごたらしい
むごらしい	むごらしい
むさい	むさい
むさくるしい	むさくるしい
むさくろしい	むさくろしい
むさ苦しい	むさ苦しい
むしあつい	むしあつい
むしづよい	むしづよい
むずい	むずい
むずかしい	むずかしい
むずがゆい	むずがゆい
むず痒い	むず痒い
むせっぽい	むせっぽい
むつかしい	むつかしい
むつまじい	むつまじい
むなぐるしい	むなぐるしい
むなしい	むなしい
むやくしい	むやくしい
めあたらしい	めあたらしい
めごい	めごい
めざとい	めざとい
めざましい	めざましい
めずらしい	めずらしい
めだたしい	めだたしい
めだるい	めだるい
めぢかい	めぢかい
めでたい	めでたい
めばしこい	めばしこい
めばやい	めばやい
めぼしい	めぼしい
めまぎらしい	めまぎらしい
めまぐるしい	めまぐるしい
めまぐろしい	めまぐろしい
めめしい	めめしい
めんこい	めんこい
めんどい	めんどい
めんどうくさい	めんどうくさい
めんどくさい	めんどくさい
めんぼくない	めんぼくない
めんもくない	めんもくない
もうしわけない	もうしわけない
もったいくさい	もったいくさい
もったいない	もったいない
もったいらしい	もったいらしい
もっともらしい	もっともらしい
もどかしい	もどかしい
ものあたらしい	ものあたらしい
ものうい	ものうい
ものおそろしい	ものおそろしい
ものおもわしい	ものおもわしい
ものがたい	ものがたい
ものがなしい	ものがなしい
ものがましい	ものがましい
ものぐさい	ものぐさい
ものぐるおしい	ものぐるおしい
ものぐるわしい	ものぐるわしい
ものこいしい	ものこいしい
ものさびしい	ものさびしい
ものさわがしい	ものさわがしい
ものすごい	ものすごい
ものすさまじい	ものすさまじい
ものたらない	ものたらない
ものたりない	ものたりない
ものなつかしい	ものなつかしい
ものほしい	ものほしい
ものみだかい	ものみだかい
ものめずらしい	ものめずらしい
ものものしい	ものものしい
ものやさしい	ものやさしい
ものわびしい	ものわびしい
もみない	もみない
もむない	もむない
もろい	もろい
やかましい	やかましい
やくない	やくない
やさしい	やさしい
やすい	やすい
やすっぽい	やすっぽい
やすぼったい	やすぼったい
やっこい	やっこい
やつやつしい	やつやつしい
やにこい	やにこい
やにっこい	やにっこい
やばい	やばい
やぼい	やぼい
やぼがたい	やぼがたい
やぼくさい	やぼくさい
やぼったい	やぼったい
やまいよわい	やまいよわい
やましい	やましい
やまぶかい	やまぶかい
やみがたい	やみがたい
やむない	やむない
ややこしい	ややこしい
やらこい	やらこい
やりにくい	やりにくい
やるかたない	やるかたない
やるせない	やるせない
やわい	やわい
やわらかい	やわらかい
やわらこい	やわらこい
やんごとない	やんごとない
ゆえない	ゆえない
ゆかしい	ゆかしい
ゆきぶかい	ゆきぶかい
ゆゆしい	ゆゆしい
ゆるい	ゆるい
ゆるかしい	ゆるかしい
ゆるぎない	ゆるぎない
よい	よい
ようがましい	ようがましい
ようじんぶかい	ようじんぶかい
よぎない	よぎない
よくどしい	よくどしい
よくぶかい	よくぶかい
よざとい	よざとい
よしない	よしない
よそがましい	よそがましい
よそよそしい	よそよそしい
よどみない	よどみない
よねんない	よねんない
よろこばしい	よろこばしい
よろしい	よろしい
よわい	よわい
よわよわしい	よわよわしい
よんどころない	よんどころない
らしくない	らしくない
らちない	らちない
らんがしい	らんがしい
りくつくさい	りくつくさい
りくつっぽい	りくつっぽい
りりしい	りりしい
れいぎただしい	れいぎただしい
れいれいしい	れいれいしい
ろくでもない	ろくでもない
わかい	わかい
わかちがたい	わかちがたい
わかりにくい	わかりにくい
わかりやすい	わかりやすい
わかりよい	わかりよい
わかわかしい	わかわかしい
わけない	わけない
わざとがましい	わざとがましい
わざとらしい	わざとらしい
わすれがたい	わすれがたい
わすれっぽい	わすれっぽい
わずらわしい	わずらわしい
わっけもない	わっけもない
わっけも無い	わっけも無い
わびしい	わびしい
わらべしい	わらべしい
わりない	わりない
わるい	わるい
わるがしこい	わるがしこい
わるがたい	わるがたい
わるくさい	わるくさい
エモい	エモい
エロい	エロい
グロい	グロい
ナウい	ナウい
バタくさい	バタくさい
バタ臭いバタ臭い	バタ臭いバタ臭い
万遍ない	万遍ない
下種い	下種い
不味い	不味い
不敵ない	不敵ない
不甲斐無い	不甲斐無い
不精ったらしい	不精ったらしい
与し易い	与し易い
世知賢い	世知賢い
世知辛い	世知辛い
並びない	並びない
並び無い	並び無い
丸い	丸い
丸っこい	丸っこい
丸まこい	丸まこい
丸まっこい	丸まっこい
丸まっちい	丸まっちい
久しい	久しい
乏しい	乏しい
乱がしい	乱がしい
乳臭い	乳臭い
事事しい	事事しい
事新しい	事新しい
事細かい	事細かい
五月蠅い	五月蠅い
亡い	亡い
人がましい	人がましい
人らしい	人らしい
人体らしい	人体らしい
人恋しい	人恋しい
人悪い	人悪い
人懐かしい	人懐かしい
人懐こい	人懐こい
人物らしい	人物らしい
人臭い	人臭い
人近い	人近い
人遠い	人遠い
人間らしい	人間らしい
人間臭い	人間臭い
人高い	人高い
仄明るい	仄明るい
仄暗い	仄暗い
仄白い	仄白い
今めかしい	今めかしい
今更らしい	今更らしい
仏臭い	仏臭い
仔細らしい	仔細らしい
仕方無い	仕方無い
他愛ない	他愛ない
他愛無い	他愛無い
付きとも無い	付きとも無い
仰仰しい	仰仰しい
似つこらしい	似つこらしい
似付かわしい	似付かわしい
似合しい	似合しい
似合わしい	似合わしい
似気無い	似気無い
低い	低い
住み憂い	住み憂い
何心無い	何心無い
何気無い	何気無い
余儀無い	余儀無い
余念無い	余念無い
余所がましい	余所がましい
余所余所しい	余所余所しい
佳い	佳い
侘しい	侘しい
俗っぽい	俗っぽい
信心深い	信心深い
倹しい	倹しい
偉い	偉い
偏無い	偏無い
催促がましい	催促がましい
傷ましい	傷ましい
僻みっぽい	僻みっぽい
儚い	儚い
優しい	優しい
全い	全い
円い	円い
冥い	冥い
冱え冱えしい	冱え冱えしい
冴え冴えしい	冴え冴えしい
冷たい	冷たい
冷っこい	冷っこい
冷まじい	冷まじい
冷やこい	冷やこい
冷やっこい	冷やっこい
凄い	凄い
凄まじい	凄まじい
凜凜しい	凜凜しい
凹い	凹い
分かち難い	分かち難い
分かり易い	分かり易い
分かり良い	分かり良い
分かり難い	分かり難い
分ち難い	分ち難い
分り難い	分り難い
分別らしい	分別らしい
分別臭い	分別臭い
分厚い	分厚い
切ない	切ない
初い	初い
初初しい	初初しい
初心い	初心い
刳い	刳い
刺刺しい	刺刺しい
劇しい	劇しい
力強い	力強い
力無い	力無い
助兵衛ったらしい	助兵衛ったらしい
労しい	労しい
勇ましい	勇ましい
勘定高い	勘定高い
勘弁強い	勘弁強い
勝手がましい	勝手がましい
勝負強い	勝負強い
勿体らしい	勿体らしい
勿体無い	勿体無い
勿体臭い	勿体臭い
半可臭い	半可臭い
半端ない	半端ない
卑しい	卑しい
印象深い	印象深い
危うい	危うい
危ない	危ない
危なげない	危なげない
危なっかしい	危なっかしい
厚い	厚い
厚かましい	厚かましい
厚ぼったい	厚ぼったい
厭きっぽい	厭きっぽい
厭みたらしい	厭みたらしい
厭らしい	厭らしい
厭わしい	厭わしい
厳い	厳い
厳しい	厳しい
厳つい	厳つい
厳めい	厳めい
厳めしい	厳めしい
去り難い	去り難い
又無い	又無い
及び難い	及び難い
取っ付き易い	取っ付き易い
取っ付き難い	取っ付き難い
口さがない	口さがない
口喧しい	口喧しい
口固い	口固い
口堅い	口堅い
口寂しい	口寂しい
口幅たい	口幅たい
口幅ったい	口幅ったい
口広い	口広い
口惜しい	口惜しい
口汚い	口汚い
口淋しい	口淋しい
口煩い	口煩い
口穢い	口穢い
口舌がましい	口舌がましい
口賢い	口賢い
口軽い	口軽い
口近い	口近い
口重い	口重い
古い	古い
古しい	古しい
古めかしい	古めかしい
古古しい	古古しい
古臭い	古臭い
可愛い	可愛い
可愛らしい	可愛らしい
吉い	吉い
同じい	同じい
名残惜しい	名残惜しい
名残無い	名残無い
名立てがましい	名立てがましい
名高い	名高い
吝い	吝い
呆気ない	呆気ない
呪わしい	呪わしい
味わい深い	味わい深い
味気ない	味気ない
味気無い	味気無い
味無い	味無い
咽せっぽい	咽せっぽい
咽っぽい	咽っぽい
哀しい	哀しい
哀れっぽい	哀れっぽい
哀れみ深い	哀れみ深い
善い	善い
喋喋しい	喋喋しい
喜ばしい	喜ばしい
喧しい	喧しい
喧嘩っ早い	喧嘩っ早い
喧嘩早い	喧嘩早い
嘆かわしい	嘆かわしい
嘘っぽい	嘘っぽい
噎せっぽい	噎せっぽい
噓っぽい	噓っぽい
囂しい	囂しい
四角い	四角い
回りくどい	回りくどい
回り諄い	回り諄い
回り遠い	回り遠い
図図しい	図図しい
図太い	図太い
図無い	図無い
固い	固い
土臭い	土臭い
均しい	均しい
坊主臭い	坊主臭い
埃っぽい	埃っぽい
埒無い	埒無い
執念い	執念い
執念深い	執念深い
堅い	堅い
堅くろしい	堅くろしい
堅苦しい	堅苦しい
堆い	堆い
堪え難い	堪え難い
堪難い	堪難い
塩っぱい	塩っぱい
塩辛い	塩辛い
外懐かしい	外懐かしい
外様がましい	外様がましい
多い	多い
多かり	多かり
夜聡い	夜聡い
夥しい	夥しい
大きい	大きい
大っきい	大っきい
大づけない	大づけない
大事ない	大事ない
大事無い	大事無い
大人しい	大人しい
大人っぽい	大人っぽい
大人気ない	大人気ない
大人気無い	大人気無い
大切ない	大切ない
大大しい	大大しい
大層らしい	大層らしい
天骨も無い	天骨も無い
天骨無い	天骨無い
太い	太い
太太しい	太太しい
奥床しい	奥床しい
奥深い	奥深い
女らしい	女らしい
女女しい	女女しい
女子らしい	女子らしい
女臭い	女臭い
好い	好い
好いたらしい	好いたらしい
好かんたらしい	好かんたらしい
好ましい	好ましい
好もしい	好もしい
如何しい	如何しい
如何わしい	如何わしい
如在無い	如在無い
如才無い	如才無い
妬い	妬い
妬ましい	妬ましい
委しい	委しい
姦しい	姦しい
婀娜っぽい	婀娜っぽい
嫉い	嫉い
嫉ましい	嫉ましい
嫉妬深い	嫉妬深い
嫌みたらしい	嫌みたらしい
嫌らしい	嫌らしい
嬉しい	嬉しい
嬉し悲しい	嬉し悲しい
子供っぽい	子供っぽい
子供らしい	子供らしい
子早い	子早い
子細らしい	子細らしい
存じ掛け無い	存じ掛け無い
安い	安い
安っぽい	安っぽい
安ぼったい	安ぼったい
宏い	宏い
定め無い	定め無い
宜い	宜い
宜しい	宜しい
実らしい	実らしい
容易い	容易い
寂しい	寂しい
寒い	寒い
寒寒しい	寒寒しい
寝汚い	寝汚い
寝濃い	寝濃い
寝穢い	寝穢い
寝聡い	寝聡い
寝臭い	寝臭い
寝苦しい	寝苦しい
寡い	寡い
尊い	尊い
小さい	小さい
小ちゃい	小ちゃい
小っ恥ずかしい	小っ恥ずかしい
小っ酷い	小っ酷い
小便臭い	小便臭い
小喧しい	小喧しい
小安い	小安い
小寂しい	小寂しい
小寒い	小寒い
小忙しい	小忙しい
小恥ずかしい	小恥ずかしい
小憎い	小憎い
小憎らしい	小憎らしい
小早い	小早い
小暗い	小暗い
小止み無い	小止み無い
小気味好い	小気味好い
小気味悪い	小気味悪い
小汚い	小汚い
小無益しい	小無益しい
小焦れったい	小焦れったい
小煩い	小煩い
小狡い	小狡い
小甘い	小甘い
小短い	小短い
小舌たるい	小舌たるい
小舌怠い	小舌怠い
小賢しい	小賢しい
小長い	小長い
小難しい	小難しい
小面憎い	小面憎い
小高い	小高い
少ない	少ない
尠い	尠い
尤もらしい	尤もらしい
尻こそばゆい	尻こそばゆい
尻擽い	尻擽い
居苦しい	居苦しい
居辛い	居辛い
屈託無い	屈託無い
山深い	山深い
嵩高い	嵩高い
嶮しい	嶮しい
差し出がましい	差し出がましい
差出がましい	差出がましい
差支え無い	差支え無い
已む無い	已む無い
幅ったい	幅ったい
幅広い	幅広い
平い	平い
平たい	平たい
平ったい	平ったい
平べったい	平べったい
年寄り臭い	年寄り臭い
年寄臭い	年寄臭い
年若い	年若い
幼い	幼い
幼けない	幼けない
幼らしい	幼らしい
幼気ない	幼気ない
幾久しい	幾久しい
広い	広い
床しい	床しい
底堅い	底堅い
底寂しい	底寂しい
底寒い	底寒い
底気味悪い	底気味悪い
底深い	底深い
度し難い	度し難い
引っ切り無い	引っ切り無い
弘い	弘い
弛い	弛い
弛み無い	弛み無い
弱い	弱い
弱弱しい	弱弱しい
強い	強い
強請りがましい	強請りがましい
強請り臭い	強請り臭い
当て付けがましい	当て付けがましい
待ち侘しい	待ち侘しい
待ち遠い	待ち遠い
待ち遠しい	待ち遠しい
待遠い	待遠い
待遠しい	待遠しい
律律しい	律律しい
後ろめたい	後ろめたい
後ろ暗い	後ろ暗い
後ろ汚い	後ろ汚い
後ろ穢い	後ろ穢い
徒広い	徒広い
得難い	得難い
御し易い	御し易い
御し難い	御し難い
御大層らしい	御大層らしい
御安い	御安い
御寒い	御寒い
御座無い	御座無い
御高い	御高い
微笑ましい	微笑ましい
心優しい	心優しい
心地好い	心地好い
心嬉しい	心嬉しい
心安い	心安い
心寂しい	心寂しい
心寒い	心寒い
心弱い	心弱い
心強い	心強い
心忙しい	心忙しい
心恥ずかしい	心恥ずかしい
心悪い	心悪い
心悲しい	心悲しい
心憎い	心憎い
心淋しい	心淋しい
心無い	心無い
心疚しい	心疚しい
心疾しい	心疾しい
心細い	心細い
心置き無い	心置き無い
心良い	心良い
心苦しい	心苦しい
心許ない	心許ない
心許無い	心許無い
心面白い	心面白い
忌まわしい	忌まわしい
忌ま忌ましい	忌ま忌ましい
忌忌しい	忌忌しい
忍びない	忍びない
忍び難い	忍び難い
忍耐強い	忍耐強い
忘れっぽい	忘れっぽい
忘れ難い	忘れ難い
忙しい	忙しい
忙しない	忙しない
忙わしい	忙わしい
忙忙しい	忙忙しい
忝い	忝い
忠実忠実しい	忠実忠実しい
快い	快い
怒りっぽい	怒りっぽい
怖い	怖い
怖らしい	怖らしい
思い出深い	思い出深い
思い掛け無い	思い掛け無い
思しい	思しい
思わしい	思わしい
思慮深い	思慮深い
怠い	怠い
性らかしい	性らかしい
怨みがましい	怨みがましい
怨めしい	怨めしい
怪しい	怪しい
恋しい	恋しい
恐い	恐い
恐らしい	恐らしい
恐れ多い	恐れ多い
恐ろしい	恐ろしい
恙無い	恙無い
恥じがましい	恥じがましい
恥ずかしい	恥ずかしい
恨みがましい	恨みがましい
恨めしい	恨めしい
恩がましい	恩がましい
恩着せがましい	恩着せがましい
恭しい	恭しい
息だわしい	息だわしい
息苦しい	息苦しい
悍い	悍い
悍ましい	悍ましい
悔しい	悔しい
悦ばしい	悦ばしい
悩ましい	悩ましい
悪い	悪い
悪しい	悪しい
悪堅い	悪堅い
悪臭い	悪臭い
悪賢い	悪賢い
悲しい	悲しい
情けらしい	情けらしい
情け深い	情け深い
情け無い	情け無い
惚れっぽい	惚れっぽい
惜しい	惜しい
惜しみ無い	惜しみ無い
惨い	惨い
惨たらしい	惨たらしい
惨らしい	惨らしい
意地くね悪い	意地くね悪い
意地悪い	意地悪い
意地汚い	意地汚い
意義深い	意義深い
愚かしい	愚かしい
愚痴っぽい	愚痴っぽい
愛い	愛い
愛おしい	愛おしい
愛くるしい	愛くるしい
愛しい	愛しい
愛しらしい	愛しらしい
愛らしい	愛らしい
愛嬌らしい	愛嬌らしい
愛愛しい	愛愛しい
愛敬らしい	愛敬らしい
感じ易い	感じ易い
感慨深い	感慨深い
慈悲深い	慈悲深い
態とがましい	態とがましい
態とらしい	態とらしい
慌ただしい	慌ただしい
慎ましい	慎ましい
慎み深い	慎み深い
慕わしい	慕わしい
慚無い	慚無い
憂い	憂い
憂わしい	憂わしい
憎い	憎い
憎たらしい	憎たらしい
憎っくい	憎っくい
憎っこい	憎っこい
憎らしい	憎らしい
憎体らしい	憎体らしい
憎憎しい	憎憎しい
憤ろしい	憤ろしい
懈い	懈い
懐かしい	懐かしい
懐こい	懐こい
懐しい	懐しい
懐っこい	懐っこい
懶い	懶い
我強い	我強い
我慢強い	我慢強い
戯しい	戯しい
所在無い	所在無い
所狭い	所狭い
手っ取り早い	手っ取り早い
手厚い	手厚い
手厳しい	手厳しい
手堅い	手堅い
手広い	手広い
手強い	手強い
手持ち悪い	手持ち悪い
手持ち無い	手持ち無い
手捷い	手捷い
手早い	手早い
手渋い	手渋い
手狭い	手狭い
手痛い	手痛い
手短い	手短い
手穢い	手穢い
手粘い	手粘い
手緩い	手緩い
手荒い	手荒い
手薄い	手薄い
手軽い	手軽い
手近い	手近い
手酷い	手酷い
手重い	手重い
手鈍い	手鈍い
打たれ弱い	打たれ弱い
打たれ強い	打たれ強い
折り目正しい	折り目正しい
折目正しい	折目正しい
抜き難い	抜き難い
抜難い	抜難い
抹香臭い	抹香臭い
押し付けがましい	押し付けがましい
押し強い	押し強い
押付けがましい	押付けがましい
拗い	拗い
拗ねい	拗ねい
拗ねくろしい	拗ねくろしい
拙い	拙い
拠ん所無い	拠ん所無い
拠所無い	拠所無い
拠無い	拠無い
捗捗しい	捗捗しい
捷い	捷い
揺るぎ無い	揺るぎ無い
擽ったい	擽ったい
故い	故い
故無い	故無い
敏い	敏い
敏捷い	敏捷い
救い難い	救い難い
敢え無い	敢え無い
斉しい	斉しい
新しい	新しい
日向臭い	日向臭い
旧い	旧い
旧しい	旧しい
旧旧しい	旧旧しい
旨い	旨い
旨旨しい	旨旨しい
早い	早い
明け易い	明け易い
明るい	明るい
昏い	昏い
易い	易い
易しい	易しい
是非ない	是非ない
是非無い	是非無い
晴れがましい	晴れがましい
晴れ晴れしい	晴れ晴れしい
晴晴しい	晴晴しい
暑い	暑い
暑苦しい	暑苦しい
暖かい	暖かい
暗い	暗い
暮れ易い	暮れ易い
曲が曲がしい	曲が曲がしい
有り難い	有り難い
有難い	有難い
望ましい	望ましい
期し難い	期し難い
木暗い	木暗い
木深い	木深い
木目細かい	木目細かい
未練がましい	未練がましい
未練たらしい	未練たらしい
未練臭い	未練臭い
末恐ろしい	末恐ろしい
末頼もしい	末頼もしい
本意無い	本意無い
果てし無い	果てし無い
果敢無い	果敢無い
果果しい	果果しい
果無い	果無い
柔い	柔い
柔らかい	柔らかい
柔らこい	柔らこい
根強い	根強い
根深い	根深い
極まりない	極まりない
極まり悪い	極まり悪い
極まり無い	極まり無い
極り悪い	極り悪い
楽しい	楽しい
様がましい	様がましい
権高い	権高い
欲しい	欲しい
欲どしい	欲どしい
欲深い	欲深い
止み難い	止み難い
止む無い	止む無い
止ん事無い	止ん事無い
正しい	正しい
正体無い	正体無い
歯痒い	歯痒い
残り多い	残り多い
残り少ない	残り少ない
残り惜しい	残り惜しい
毒毒しい	毒毒しい
毛深い	毛深い
気まずい	気まずい
気不味い	気不味い
気味好い	気味好い
気味悪い	気味悪い
気太い	気太い
気安い	気安い
気弱い	気弱い
気強い	気強い
気忙しい	気忙しい
気忙しない	気忙しない
気怠い	気怠い
気恥ずかしい	気恥ずかしい
気懈い	気懈い
気持ち好い	気持ち好い
気持ち悪い	気持ち悪い
気持ち良い	気持ち良い
気早い	気早い
気疎い	気疎い
気細い	気細い
気術無い	気術無い
気軽い	気軽い
気遠い	気遠い
気遣わしい	気遣わしい
気長い	気長い
気障ったらしい	気障ったらしい
気障っぽい	気障っぽい
気難しい	気難しい
気高い	気高い
水っぽい	水っぽい
水水しい	水水しい
水臭い	水臭い
永い	永い
永永しい	永永しい
汗臭い	汗臭い
汚い	汚い
汚らしい	汚らしい
汚らわしい	汚らわしい
決まり悪い	決まり悪い
決り悪い	決り悪い
油っこい	油っこい
泥深い	泥深い
泥臭い	泥臭い
注意深い	注意深い
洒落臭い	洒落臭い
派手派手しい	派手派手しい
浄い	浄い
浅い	浅い
浅ましい	浅ましい
浅浅しい	浅浅しい
浅黒い	浅黒い
涙ぐましい	涙ぐましい
涙強い	涙強い
涙脆い	涙脆い
涼しい	涼しい
淀み無い	淀み無い
淋しい	淋しい
淡い	淡い
淡淡しい	淡淡しい
深い	深い
深しい	深しい
清い	清い
清しい	清しい
清清しい	清清しい
渋い	渋い
温い	温い
温かい	温かい
温とい	温とい
湿っぽい	湿っぽい
湿気っぽい	湿気っぽい
湿気臭い	湿気臭い
湿深い	湿深い
満遍ない	満遍ない
滑こい	滑こい
滑っこい	滑っこい
潔い	潔い
澱み無い	澱み無い
激しい	激しい
濃い	濃い
濃ゆい	濃ゆい
濫りがましい	濫りがましい
濫りがわしい	濫りがわしい
為ん方無い	為ん方無い
為ん術ない	為ん術ない
為ん術無い	為ん術無い
為難い	為難い
烈しい	烈しい
烏滸がましい	烏滸がましい
烟い	烟い
烟たい	烟たい
烟ったい	烟ったい
無い	無い
無益しい	無益しい
無精ったらしい	無精ったらしい
焦げ臭い	焦げ臭い
焦れったい	焦れったい
然で無い	然で無い
然りげ無い	然りげ無い
煙い	煙い
煙たい	煙たい
煙ったい	煙ったい
照れ臭い	照れ臭い
煩い	煩い
煩わしい	煩わしい
熟柿臭い	熟柿臭い
熱い	熱い
熱っぽい	熱っぽい
熱臭い	熱臭い
熱苦しい	熱苦しい
爺むさい	爺むさい
片腹痛い	片腹痛い
物がましい	物がましい
物佗しい	物佗しい
物侘しい	物侘しい
物優しい	物優しい
物凄い	物凄い
物凄じい	物凄じい
物凄まじい	物凄まじい
物堅い	物堅い
物寂しい	物寂しい
物思わしい	物思わしい
物恋しい	物恋しい
物恐ろしい	物恐ろしい
物悲しい	物悲しい
物憂い	物憂い
物懐かしい	物懐かしい
物新しい	物新しい
物欲しい	物欲しい
物淋しい	物淋しい
物物しい	物物しい
物狂おしい	物狂おしい
物狂わしい	物狂わしい
物珍しい	物珍しい
物臭い	物臭い
物見高い	物見高い
物足らない	物足らない
物足りない	物足りない
物騒がしい	物騒がしい
犯し難い	犯し難い
狂おしい	狂おしい
狂わしい	狂わしい
狎狎しい	狎狎しい
狡い	狡い
狡っ辛い	狡っ辛い
狡賢い	狡賢い
狡辛い	狡辛い
狭い	狭い
狭苦しい	狭苦しい
猛猛しい	猛猛しい
猥りがましい	猥りがましい
猥りがわしい	猥りがわしい
猿賢い	猿賢い
珍しい	珍しい
理屈っぽい	理屈っぽい
理屈臭い	理屈臭い
理無い	理無い
瑞瑞しい	瑞瑞しい
甘い	甘い
甘たるい	甘たるい
甘ちこい	甘ちこい
甘ちょろい	甘ちょろい
甘ったるい	甘ったるい
甘っちょろい	甘っちょろい
甘塩っぱい	甘塩っぱい
甘辛い	甘辛い
甘酸っぱい	甘酸っぱい
甚い	甚い
甚だしい	甚だしい
生っちょろい	生っちょろい
生っ白い	生っ白い
生優しい	生優しい
生新しい	生新しい
生易しい	生易しい
生暖かい	生暖かい
生温い	生温い
生熱い	生熱い
生生しい	生生しい
生白い	生白い
生臭い	生臭い
生若い	生若い
生長い	生長い
用心深い	用心深い
田舎臭い	田舎臭い
由無い	由無い
由由しい	由由しい
甲斐無い	甲斐無い
甲斐甲斐しい	甲斐甲斐しい
甲高い	甲高い
申し訳無い	申し訳無い
申訳ない	申訳ない
申訳無い	申訳無い
男らしい	男らしい
男男しい	男男しい
男臭い	男臭い
畏い	畏い
畏れ多い	畏れ多い
異なりい	異なりい
疎い	疎い
疎ましい	疎ましい
疎疎しい	疎疎しい
疑い深い	疑い深い
疑い無い	疑い無い
疑り深い	疑り深い
疑わしい	疑わしい
疚しい	疚しい
疳高い	疳高い
疾しい	疾しい
病弱い	病弱い
痒い	痒い
痛い	痛い
痛ましい	痛ましい
痛気持ち好い	痛気持ち好い
痛痒い	痛痒い
痛痛しい	痛痛しい
痴がましい	痴がましい
白い	白い
白っぽい	白っぽい
白白しい	白白しい
白粉臭い	白粉臭い
益無い	益無い
目怠い	目怠い
目捷い	目捷い
目敏い	目敏い
目新しい	目新しい
目早い	目早い
目映ゆい	目映ゆい
目立たしい	目立たしい
目紛しい	目紛しい
目紛らしい	目紛らしい
目紛るしい	目紛るしい
目聡い	目聡い
目覚しい	目覚しい
目覚ましい	目覚ましい
目近い	目近い
相応しい	相応しい
相等しい	相等しい
眉目良い	眉目良い
眉目麗しい	眉目麗しい
真っ白い	真っ白い
真っ黒い	真っ黒い
真ん丸い	真ん丸い
真ん円い	真ん円い
真新しい	真新しい
真白い	真白い
眠い	眠い
眠たい	眠たい
眩い	眩い
眩しい	眩しい
睡い	睡い
睡たい	睡たい
睦まじい	睦まじい
短い	短い
硬い	硬い
碌でもない	碌でもない
確からしい	確からしい
磯臭い	磯臭い
礼儀正しい	礼儀正しい
神神しい	神神しい
禍禍しい	禍禍しい
福福しい	福福しい
程好い	程好い
程良い	程良い
程近い	程近い
程遠い	程遠い
稚い	稚い
稚ない	稚ない
穢い	穢い
穢らしい	穢らしい
穢らわしい	穢らわしい
空しい	空しい
空恐ろしい	空恐ろしい
空恥ずかしい	空恥ずかしい
空空しい	空空しい
窪い	窪い
窶窶しい	窶窶しい
童しい	童しい
端近い	端近い
笑止い	笑止い
等しい	等しい
等閑ない	等閑ない
筋無い	筋無い
筋目正しい	筋目正しい
算盤高い	算盤高い
篇無い	篇無い
篤い	篤い
篦太い	篦太い
篦深い	篦深い
粗い	粗い
粗っぽい	粗っぽい
粘い	粘い
粘っこい	粘っこい
粘り強い	粘り強い
精しい	精しい
糠味噌臭い	糠味噌臭い
約しい	約しい
紅い	紅い
紙子臭い	紙子臭い
紛らわしい	紛らわしい
素っ気無い	素っ気無い
素人臭い	素人臭い
素懐かしい	素懐かしい
素早い	素早い
素晴しい	素晴しい
素晴らしい	素晴らしい
素気無い	素気無い
細い	細い
細かい	細かい
細かしい	細かしい
細細しい	細細しい
細長い	細長い
絶え間無い	絶え間無い
絶間無い	絶間無い
継しい	継しい
緩い	緩い
緩かしい	緩かしい
縁遠い	縁遠い
繁い	繁い
罪深い	罪深い
美い	美い
美しい	美しい
美味しい	美味しい
美美しい	美美しい
羞ずかしい	羞ずかしい
羨しい	羨しい
羨ましい	羨ましい
義強い	義強い
義理堅い	義理堅い
義理強い	義理強い
義理義理しい	義理義理しい
耀かしい	耀かしい
考え深い	考え深い
耳新しい	耳新しい
耳早い	耳早い
耳珍しい	耳珍しい
耳聡い	耳聡い
耳苦しい	耳苦しい
耳遠い	耳遠い
聞きとも無い	聞きとも無い
聞き悪い	聞き悪い
聞き良い	聞き良い
聞き苦しい	聞き苦しい
聞き辛い	聞き辛い
聞き難い	聞き難い
聞良い	聞良い
聞苦しい	聞苦しい
聡い	聡い
肌寂しい	肌寂しい
肌寒い	肌寒い
肌理細かい	肌理細かい
胡散らしい	胡散らしい
胡散臭い	胡散臭い
胸苦しい	胸苦しい
脂こい	脂こい
脂っこい	脂っこい
脆い	脆い
腑甲斐無い	腑甲斐無い
腕弛い	腕弛い
腥い	腥い
腫れぼったい	腫れぼったい
腰軽い	腰軽い
腹汚い	腹汚い
腹穢い	腹穢い
腹立たしい	腹立たしい
腹黒い	腹黒い
膚寒い	膚寒い
自慢たらしい	自慢たらしい
自慢臭い	自慢臭い
自由がましい	自由がましい
臭い	臭い
興味深い	興味深い
舌たるい	舌たるい
舌怠い	舌怠い
良い	良い
色っぽい	色っぽい
色好い	色好い
艶かしい	艶かしい
艶っぽい	艶っぽい
艶めかしい	艶めかしい
艶艶しい	艶艶しい
花恥ずかしい	花恥ずかしい
花花しい	花花しい
芳しい	芳しい
芳ばしい	芳ばしい
苛立たしい	苛立たしい
苛苛しい	苛苛しい
苛酷い	苛酷い
若い	若い
若若しい	若若しい
苦い	苦い
苦しい	苦しい
苦っぽい	苦っぽい
苦苦しい	苦苦しい
茶っぽい	茶っぽい
茶色い	茶色い
草深い	草深い
荒い	荒い
荒くもしい	荒くもしい
荒っぽい	荒っぽい
荒気ない	荒気ない
荒荒しい	荒荒しい
華華しい	華華しい
著しい	著しい
蒸し暑い	蒸し暑い
蒸暑い	蒸暑い
蒼い	蒼い
蒼白い	蒼白い
薄い	薄い
薄べったい	薄べったい
薄ら寒い	薄ら寒い
薄寂しい	薄寂しい
薄寒い	薄寒い
薄明るい	薄明るい
薄暗い	薄暗い
薄気味悪い	薄気味悪い
薄汚い	薄汚い
薄甘い	薄甘い
薄白い	薄白い
薄穢い	薄穢い
薄鈍い	薄鈍い
薄黒い	薄黒い
蘞い	蘞い
蘞辛い	蘞辛い
蘞辛っぽい	蘞辛っぽい
虔しい	虔しい
虚しい	虚しい
虫強い	虫強い
血腥い	血腥い
血臭い	血臭い
行儀強い	行儀強い
行儀正しい	行儀正しい
術無い	術無い
見え難い	見え難い
見たむない	見たむない
見っともない	見っともない
見とうもない	見とうもない
見好い	見好い
見易い	見易い
見目好い	見目好い
見目麗しい	見目麗しい
見窄らしい	見窄らしい
見臭い	見臭い
見良い	見良い
見苦しい	見苦しい
見辛い	見辛い
見難い	見難い
規則正しい	規則正しい
覚しい	覚しい
覚束無い	覚束無い
親げない	親げない
親しい	親しい
親しみ深い	親しみ深い
角い	角い
角角しい	角角しい
言い難い	言い難い
言難い	言難い
計算高い	計算高い
託言がましい	託言がましい
訝しい	訝しい
訳無い	訳無い
詮方無い	詮方無い
詮無い	詮無い
詳しい	詳しい
誇らしい	誇らしい
誇り高い	誇り高い
諄い	諄い
謂れ無い	謂れ無い
豪い	豪い
負えない	負えない
負へない	負へない
貧しい	貧しい
貧乏たらしい	貧乏たらしい
貧乏臭い	貧乏臭い
貴い	貴い
賑わしい	賑わしい
賑賑しい	賑賑しい
賢い	賢い
賢しい	賢しい
賤しい	賤しい
赤い	赤い
赤黒い	赤黒い
赫かしい	赫かしい
足し無い	足し無い
足近い	足近い
跡形無い	跡形無い
身軽い	身軽い
身近い	身近い
軟らかい	軟らかい
軟らこい	軟らこい
軽い	軽い
軽薄らしい	軽薄らしい
軽軽しい	軽軽しい
輝かしい	輝かしい
辛い	辛い
辛抱強い	辛抱強い
辛気臭い	辛気臭い
辱い	辱い
近い	近い
近しい	近しい
逞しい	逞しい
速い	速い
造作無い	造作無い
遅い	遅い
遠い	遠い
遠慮深い	遠慮深い
遠遠しい	遠遠しい
遣り難い	遣り難い
遣る方無い	遣る方無い
遣る瀬無い	遣る瀬無い
遽しい	遽しい
避り難い	避り難い
邪推深い	邪推深い
邪魔臭い	邪魔臭い
部厚い	部厚い
酒臭い	酒臭い
酷い	酷い
酷しい	酷しい
酷たらしい	酷たらしい
酷らしい	酷らしい
酸い	酸い
酸っぱい	酸っぱい
醜い	醜い
醶い	醶い
重い	重い
重たい	重たい
重ったるい	重ったるい
重苦しい	重苦しい
重重しい	重重しい
野太い	野太い
野広い	野広い
野暮い	野暮い
野暮ったい	野暮ったい
野暮堅い	野暮堅い
野暮臭い	野暮臭い
金臭い	金臭い
鈍い	鈍い
鈍ましい	鈍ましい
鈍臭い	鈍臭い
鋭い	鋭い
長い	長い
長たらしい	長たらしい
長ったらしい	長ったらしい
長っ細い	長っ細い
長細い	長細い
長長しい	長長しい
間怠い	間怠い
間怠こい	間怠こい
間怠こしい	間怠こしい
間怠っこい	間怠っこい
間怠っこしい	間怠っこしい
間緩い	間緩い
間近い	間近い
間遠い	間遠い
間鈍い	間鈍い
闇い	闇い
阿呆らしい	阿呆らしい
阿呆臭い	阿呆臭い
限り無い	限り無い
陰気臭い	陰気臭い
陳臭い	陳臭い
陸でもない	陸でもない
険しい	険しい
隔てがましい	隔てがましい
際疾い	際疾い
隠れ無い	隠れ無い
雄雄しい	雄雄しい
難い	難い
難しい	難しい
難有い	難有い
雪深い	雪深い
青い	青い
青っぽい	青っぽい
青白い	青白い
青臭い	青臭い
青黒い	青黒い
非道い	非道い
面倒い	面倒い
面倒臭い	面倒臭い
面当てがましい	面当てがましい
面憎い	面憎い
面映い	面映い
面映ゆい	面映ゆい
面白い	面白い
面白おかしい	面白おかしい
面目無い	面目無い
面黒い	面黒い
頑是無い	頑是無い
頓着無い	頓着無い
頰笑ましい	頰笑ましい
頼み少ない	頼み少ない
頼もしい	頼もしい
頼り無い	頼り無い
願わしい	願わしい
類いない	類いない
類い無い	類い無い
飽きっぽい	飽きっぽい
飽き易い	飽き易い
饐え臭い	饐え臭い
饑い	饑い
香しい	香しい
香ばしい	香ばしい
馨しい	馨しい
馬鹿でかい	馬鹿でかい
馬鹿らしい	馬鹿らしい
馬鹿臭い	馬鹿臭い
馬鹿馬鹿しい	馬鹿馬鹿しい
馬鹿高い	馬鹿高い
馴れ馴れしい	馴れ馴れしい
馴染み深い	馴染み深い
騒がしい	騒がしい
騒がましい	騒がましい
騒騒しい	騒騒しい
骨っぽい	骨っぽい
高い	高い
鬱悒い	鬱悒い
鬱陶しい	鬱陶しい
鬼鬼しい	鬼鬼しい
鮸膠無い	鮸膠無い
鰾膠無い	鰾膠無い
鹹い	鹹い
鹹映ゆい	鹹映ゆい
鹿爪らしい	鹿爪らしい
麗しい	麗しい
麗麗しい	麗麗しい
黄色い	黄色い
黒い	黒い
黒っぽい	黒っぽい
黝い	黝い
黴臭い	黴臭い
