あいたずさえる	あいたずさえる
あいつうじる	あいつうじる
あいつとめる	あいつとめる
あいにる	あいにる
あいはてる	あいはてる
あいみる	あいみる
あえる	あえる
あおぎたてる	あおぎたてる
あおぎみる	あおぎみる
あおざめる	あおざめる
あおのける	あおのける
あおびれる	あおびれる
あおむける	あおむける
あおりたてる	あおりたてる
あおりつける	あおりつける
あかじみる	あかじみる
あかせる	あかせる
あかちゃける	あかちゃける
あかぬける	あかぬける
あかめる	あかめる
あかやける	あかやける
あからめる	あからめる
あがめる	あがめる
あきたりる	あきたりる
あきらめる	あきらめる
あきる	あきる
あきれはてる	あきれはてる
あきれる	あきれる
あくがれる	あくがれる
あくたれる	あくたれる
あぐねる	あぐねる
あけくれる	あけくれる
あけそめる	あけそめる
あけはなれる	あけはなれる
あけひろげる	あけひろげる
あける	あける
あげる	あげる
あこがれる	あこがれる
あざれる	あざれる
あずけいれる	あずけいれる
あずける	あずける
あせじみる	あせじみる
あせる	あせる
あそばせる	あそばせる
あそびたわむれる	あそびたわむれる
あそびほうける	あそびほうける
あたえる	あたえる
あたける	あたける
あたためる	あたためる
あっためる	あっためる
あつめる	あつめる
あつらえる	あつらえる
あてつける	あてつける
あてはめる	あてはめる
あてる	あてる
あとづける	あとづける
あばきたてる	あばきたてる
あばれる	あばれる
あびせかける	あびせかける
あびせる	あびせる
あびる	あびる
あふれでる	あふれでる
あふれる	あふれる
あぶらじみる	あぶらじみる
あぶれる	あぶれる
あまえる	あまえる
あまたれる	あまたれる
あまったれる	あまったれる
あまんじる	あまんじる
あみあげる	あみあげる
あみたてる	あみたてる
あやめる	あやめる
あらいあげる	あらいあげる
あらいたてる	あらいたてる
あらくれる	あらくれる
あらける	あらける
あらげる	あらげる
あらためる	あらためる
あらだてる	あらだてる
あらびる	あらびる
あららげる	あららげる
あらわれでる	あらわれでる
あらわれる	あらわれる
ありあわせる	ありあわせる
ありえる	ありえる
ありふれる	ありふれる
あれはてる	あれはてる
あれる	あれる
あわせる	あわせる
あわだてる	あわだてる
あわてる	あわてる
あんじる	あんじる
いあてる	いあてる
いあわせる	いあわせる
いいあてる	いいあてる
いいあわせる	いいあわせる
いいいれる	いいいれる
いいおくれる	いいおくれる
いいかえる	いいかえる
いいかける	いいかける
いいかためる	いいかためる
いいかねる	いいかねる
いいかぶせる	いいかぶせる
いいきかせる	いいきかせる
いいくるめる	いいくるめる
いいくろめる	いいくろめる
いいこしらえる	いいこしらえる
いいこめる	いいこめる
いいしらける	いいしらける
いいすぎる	いいすぎる
いいすくめる	いいすくめる
いいすてる	いいすてる
いいそえる	いいそえる
いいそそくれる	いいそそくれる
いいそびれる	いいそびれる
いいたてる	いいたてる
いいちがえる	いいちがえる
いいつける	いいつける
いいつげる	いいつげる
いいつたえる	いいつたえる
いいつづける	いいつづける
いいつめる	いいつめる
いいつらねる	いいつらねる
いいなれる	いいなれる
いいぬける	いいぬける
いいのがれる	いいのがれる
いいのける	いいのける
いいはぐれる	いいはぐれる
いいはじめる	いいはじめる
いいひろめる	いいひろめる
いいふくめる	いいふくめる
いいふせる	いいふせる
いいまける	いいまける
いいまるめる	いいまるめる
いいわける	いいわける
いえる	いえる
いかける	いかける
いからせる	いからせる
いかれる	いかれる
いがめる	いがめる
いきあわせる	いきあわせる
いきすぎる	いきすぎる
いきたえる	いきたえる
いきながらえる	いきながらえる
いきのびる	いきのびる
いきる	いきる
いきれる	いきれる
いきわかれる	いきわかれる
いける	いける
いさちる	いさちる
いさめる	いさめる
いじける	いじける
いじめる	いじめる
いすくめる	いすくめる
いせる	いせる
いそがせる	いそがせる
いただける	いただける
いたてる	いたてる
いためつける	いためつける
いためる	いためる
いちづける	いちづける
いちびる	いちびる
いっつける	いっつける
いつける	いつける
いてる	いてる
いでいる	いでいる
いとめる	いとめる
いなかじみる	いなかじみる
いなかびる	いなかびる
いながれる	いながれる
いのりあげる	いのりあげる
いばえる	いばえる
いびたれる	いびたれる
いましめる	いましめる
いみづける	いみづける
いやしめる	いやしめる
いらえる	いらえる
いらせられる	いらせられる
いらだてる	いらだてる
いられる	いられる
いりあげる	いりあげる
いりちがえる	いりちがえる
いりつける	いりつける
いりみだれる	いりみだれる
いる	いる
いれあげる	いれあげる
いれかえる	いれかえる
いれちがえる	いれちがえる
いれまぜる	いれまぜる
いれる	いれる
いろあせる	いろあせる
いろづける	いろづける
いわえる	いわえる
いわせる	いわせる
いんしょうづける	いんしょうづける
うえかえる	うえかえる
うえつける	うえつける
うえる	うえる
うかされる	うかされる
うかせる	うかせる
うかばれる	うかばれる
うかびでる	うかびでる
うかべる	うかべる
うかれでる	うかれでる
うかれる	うかれる
うきでる	うきでる
うけいれる	うけいれる
うけそんじる	うけそんじる
うけつける	うけつける
うけとめる	うけとめる
うけとれる	うけとれる
うける	うける
うしろみる	うしろみる
うじゃける	うじゃける
うじゃじゃける	うじゃじゃける
うすぼける	うすぼける
うすめる	うすめる
うすよごれる	うすよごれる
うすれる	うすれる
うずめる	うずめる
うずもれる	うずもれる
うせる	うせる
うたいあげる	うたいあげる
うたわれる	うたわれる
うちあける	うちあける
うちあげる	うちあげる
うちあてる	うちあてる
うちあわせる	うちあわせる
うちかえる	うちかえる
うちかける	うちかける
うちしおれる	うちしおれる
うちすえる	うちすえる
うちすぎる	うちすぎる
うちすてる	うちすてる
うちそんじる	うちそんじる
うちたえる	うちたえる
うちたてる	うちたてる
うちちがえる	うちちがえる
うちつける	うちつける
うちつづける	うちつづける
うちつれる	うちつれる
うちとける	うちとける
うちとめる	うちとめる
うちながめる	うちながめる
うちはじめる	うちはじめる
うちひそめる	うちひそめる
うちふるえる	うちふるえる
うちまぎれる	うちまぎれる
うちみる	うちみる
うちよせる	うちよせる
うちわすれる	うちわすれる
うちわびる	うちわびる
うったえる	うったえる
うってでる	うってでる
うつける	うつける
うつぶける	うつぶける
うつぶせる	うつぶせる
うつむける	うつむける
うでる	うでる
うとんじる	うとんじる
うなされる	うなされる
うなずける	うなずける
うなだれる	うなだれる
うぬぼれる	うぬぼれる
うまれあわせる	うまれあわせる
うまれおちる	うまれおちる
うまれでる	うまれでる
うまれる	うまれる
うみつかれる	うみつかれる
うみつける	うみつける
うみわける	うみわける
うめあわせる	うめあわせる
うめたてる	うめたてる
うめる	うめる
うもれる	うもれる
うらがれる	うらがれる
うらづける	うらづける
うらぶれる	うらぶれる
うらみる	うらみる
うりあげる	うりあげる
うりきれる	うりきれる
うりさげる	うりさげる
うりつける	うりつける
うりぬける	うりぬける
うれえる	うれえる
うれる	うれる
うろたえる	うろたえる
うわぶれる	うわぶれる
うわむける	うわむける
うんめいづける	うんめいづける
えいじる	えいじる
えぐれる	えぐれる
えじめる	えじめる
えみくずれる	えみくずれる
えみこぼれる	えみこぼれる
えみわれる	えみわれる
えりつける	えりつける
えりわける	えりわける
える	える
えんじる	えんじる
えんづける	えんづける
おいあげる	おいあげる
おいかける	おいかける
おいくちる	おいくちる
おいさびる	おいさびる
おいさらばえる	おいさらばえる
おいたてる	おいたてる
おいつめる	おいつめる
おいでなされる	おいでなされる
おいでる	おいでる
おいのける	おいのける
おいはてる	おいはてる
おいぼれる	おいぼれる
おいもとめる	おいもとめる
おいる	おいる
おうじる	おうじる
おえる	おえる
おおいかぶせる	おおいかぶせる
おおせきける	おおせきける
おおせつける	おおせつける
おおせられる	おおせられる
おおせる	おおせる
おかぼれる	おかぼれる
おきかえる	おきかえる
おきすてる	おきすてる
おきなさびる	おきなさびる
おきる	おきる
おきわすれる	おきわすれる
おくらせる	おくらせる
おくりつける	おくりつける
おくりとどける	おくりとどける
おくれる	おくれる
おこなわれる	おこなわれる
おさえつける	おさえつける
おさえる	おさえる
おさなびる	おさなびる
おさめる	おさめる
おしあける	おしあける
おしあげる	おしあげる
おしあてる	おしあてる
おしいれる	おしいれる
おしえる	おしえる
おしかける	おしかける
おしこめる	おしこめる
おしさげる	おしさげる
おししずめる	おししずめる
おしすすめる	おしすすめる
おしたてる	おしたてる
おしつける	おしつける
おしつめる	おしつめる
おしとどめる	おしとどめる
おしとめる	おしとめる
おしならべる	おしならべる
おしのける	おしのける
おしのべる	おしのべる
おしひろげる	おしひろげる
おしひろめる	おしひろめる
おしふせる	おしふせる
おしまげる	おしまげる
おしむける	おしむける
おしよせる	おしよせる
おしわける	おしわける
おじおそれる	おじおそれる
おじける	おじける
おじる	おじる
おそれる	おそれる
おそわれる	おそわれる
おだてる	おだてる
おだれる	おだれる
おちいる	おちいる
おちつける	おちつける
おちのびる	おちのびる
おちぶれる	おちぶれる
おちゃらける	おちゃらける
おちる	おちる
おっかける	おっかける
おっかじめる	おっかじめる
おっかぶせる	おっかぶせる
おっこちる	おっこちる
おったてる	おったてる
おったまげる	おったまげる
おっつくねる	おっつくねる
おっつける	おっつける
おっぱじめる	おっぱじめる
おっぴろげる	おっぴろげる
おっぷせる	おっぷせる
おっ始める	おっ始める
おっ広げる	おっ広げる
おっ立てる	おっ立てる
おっ魂消る	おっ魂消る
おとしいれる	おとしいれる
おとしめる	おとしめる
おとずれる	おとずれる
おとなじみる	おとなじみる
おとなびる	おとなびる
おとろえる	おとろえる
おどける	おどける
おどしつける	おどしつける
おどりでる	おどりでる
おのぼれる	おのぼれる
おびえる	おびえる
おびきいれる	おびきいれる
おびきよせる	おびきよせる
おびる	おびる
おぶしゃれる	おぶしゃれる
おぼえる	おぼえる
おぼれる	おぼれる
おめる	おめる
おもいあぐねる	おもいあぐねる
おもいあわせる	おもいあわせる
おもいうかべる	おもいうかべる
おもいくずれる	おもいくずれる
おもいくらべる	おもいくらべる
おもいこがれる	おもいこがれる
おもいさだめる	おもいさだめる
おもいしめる	おもいしめる
おもいしらせる	おもいしらせる
おもいちがえる	おもいちがえる
おもいつづける	おもいつづける
おもいつめる	おもいつめる
おもいひがめる	おもいひがめる
おもいみだれる	おもいみだれる
おもいみる	おもいみる
おもいもうける	おもいもうける
おもえる	おもえる
おもくれる	おもくれる
おもてだてる	おもてだてる
おもやせる	おもやせる
おもんじる	おもんじる
おもんみる	おもんみる
およがせる	およがせる
おりあげる	おりあげる
おりいる	おりいる
おりかさねる	おりかさねる
おりまげる	おりまげる
おりまぜる	おりまぜる
おりる	おりる
おれる	おれる
おんでる	おんでる
かいあげる	かいあげる
かいあたえる	かいあたえる
かいあつめる	かいあつめる
かいいれる	かいいれる
かいうける	かいうける
かいかえる	かいかえる
かいしめる	かいしめる
かいそろえる	かいそろえる
かいたてる	かいたてる
かいつける	かいつける
かいととのえる	かいととのえる
かいひかえる	かいひかえる
かいびかえる	かいびかえる
かいまける	かいまける
かいまみる	かいまみる
かいもとめる	かいもとめる
かえりみる	かえりみる
かえる	かえる
かかえる	かかえる
かかげる	かかげる
かがみる	かがみる
かがめる	かがめる
かきあげる	かきあげる
かきあつめる	かきあつめる
かきあらためる	かきあらためる
かきあわせる	かきあわせる
かきいれる	かきいれる
かきおおせる	かきおおせる
かきおさめる	かきおさめる
かきかえる	かきかえる
かききえる	かききえる
かきくれる	かきくれる
かきくわえる	かきくわえる
かきしたためる	かきしたためる
かきすてる	かきすてる
かきそえる	かきそえる
かきそんじる	かきそんじる
かきたてる	かきたてる
かきためる	かきためる
かきつける	かきつける
かきつたえる	かきつたえる
かきつづける	かきつづける
かきつらねる	かきつらねる
かきとどめる	かきとどめる
かきとめる	かきとめる
かきなでる	かきなでる
かきならべる	かきならべる
かきなれる	かきなれる
かきのける	かきのける
かきのせる	かきのせる
かきまぜる	かきまぜる
かきまちがえる	かきまちがえる
かきまみる	かきまみる
かきみだれる	かきみだれる
かきよせる	かきよせる
かきわける	かきわける
かきわすれる	かきわすれる
かぎあてる	かぎあてる
かぎつける	かぎつける
かぎわける	かぎわける
かくれる	かくれる
かけあわせる	かけあわせる
かけおりる	かけおりる
かけかえる	かけかえる
かけつける	かけつける
かけつらねる	かけつらねる
かけぬける	かけぬける
かけはなれる	かけはなれる
かけへだてる	かけへだてる
かける	かける
かこつける	かこつける
かさねる	かさねる
かざりたてる	かざりたてる
かざりつける	かざりつける
かしあたえる	かしあたえる
かしげる	かしげる
かしさげる	かしさげる
かしつける	かしつける
かしめる	かしめる
かじける	かじける
かすめる	かすめる
かすれる	かすれる
かずける	かずける
かせる	かせる
かぞえあげる	かぞえあげる
かぞえたてる	かぞえたてる
かぞえる	かぞえる
かたげる	かたげる
かたづける	かたづける
かたぶける	かたぶける
かたむける	かたむける
かためる	かためる
かたよせる	かたよせる
かたりかける	かたりかける
かたりつたえる	かたりつたえる
かちあげる	かちあげる
かちえる	かちえる
かちすぎる	かちすぎる
かちづける	かちづける
かちれる	かちれる
かっこつける	かっこつける
かっこ付ける	かっこ付ける
かつえる	かつえる
かつぎあげる	かつぎあげる
かてる	かてる
かどだてる	かどだてる
かなえる	かなえる
かなぐりすてる	かなぐりすてる
かなぐり捨てる	かなぐり捨てる
かなでる	かなでる
かねそなえる	かねそなえる
かねる	かねる
かびる	かびる
かぶせる	かぶせる
かぶれる	かぶれる
かまいつける	かまいつける
かまえる	かまえる
かまける	かまける
かませる	かませる
かみあわせる	かみあわせる
かみさびる	かみさびる
かみしめる	かみしめる
かみまぜる	かみまぜる
かみわける	かみわける
かよいつめる	かよいつめる
からげる	からげる
からびる	からびる
からませる	からませる
からみつける	からみつける
からめる	からめる
かられる	かられる
かりあげる	かりあげる
かりあつめる	かりあつめる
かりいれる	かりいれる
かりうける	かりうける
かりかえる	かりかえる
かりたてる	かりたてる
かりる	かりる
かれおちる	かれおちる
かれはてる	かれはてる
かれる	かれる
かろしめる	かろしめる
かろんじる	かろんじる
かわりはてる	かわりはてる
かんがえあわせる	かんがえあわせる
かんがえる	かんがえる
かんがみる	かんがみる
かんけいづける	かんけいづける
かんさびる	かんさびる
かんじる	かんじる
かんれんづける	かんれんづける
がえんじる	がえんじる
がなりたてる	がなりたてる
がなり立てる	がなり立てる
がめる	がめる
きあわせる	きあわせる
きえうせる	きえうせる
きえはてる	きえはてる
きえる	きえる
きかえる	きかえる
きかせる	きかせる
きがまえる	きがまえる
ききあきる	ききあきる
ききあわせる	ききあわせる
ききいれる	ききいれる
ききおぼえる	ききおぼえる
ききさだめる	ききさだめる
ききしめる	ききしめる
ききすてる	ききすてる
ききそびれる	ききそびれる
ききたがえる	ききたがえる
ききちがえる	ききちがえる
ききつける	ききつける
ききつたえる	ききつたえる
ききとがめる	ききとがめる
ききとどける	ききとどける
ききとめる	ききとめる
ききとれる	ききとれる
ききなれる	ききなれる
ききはてる	ききはてる
ききほれる	ききほれる
ききわける	ききわける
ききわすれる	ききわすれる
きくずれる	きくずれる
きける	きける
きこえる	きこえる
きざみつける	きざみつける
きしませる	きしませる
きすてる	きすてる
きずきあげる	きずきあげる
きずつける	きずつける
きせかえる	きせかえる
きせかける	きせかける
きせる	きせる
きそづける	きそづける
きたえあげる	きたえあげる
きたえる	きたえる
きちがいじみる	きちがいじみる
きっかける	きっかける
きつける	きつける
きなれる	きなれる
きぶくれる	きぶくれる
きめつける	きめつける
きめる	きめる
きょうざめる	きょうざめる
きょうじる	きょうじる
きよめる	きよめる
きりあげる	きりあげる
きりかえる	きりかえる
きりかける	きりかける
きりさげる	きりさげる
きりすてる	きりすてる
きりそろえる	きりそろえる
きりたてる	きりたてる
きりつける	きりつける
きりつめる	きりつめる
きりぬける	きりぬける
きりひろげる	きりひろげる
きりふせる	きりふせる
きりわける	きりわける
きる	きる
きれる	きれる
きわめる	きわめる
きんじる	きんじる
ぎむづける	ぎむづける
ぎんじる	ぎんじる
くいあきる	くいあきる
くいあらためる	くいあらためる
くいあわせる	くいあわせる
くいかける	くいかける
くいかねる	くいかねる
くいしめる	くいしめる
くいすぎる	くいすぎる
くいっぱぐれる	くいっぱぐれる
くいつめる	くいつめる
くいとめる	くいとめる
くいはぐれる	くいはぐれる
くいる	くいる
くえる	くえる
くくしあげる	くくしあげる
くくしつける	くくしつける
くくめる	くくめる
くくりあげる	くくりあげる
くくりつける	くくりつける
くくれる	くくれる
くぐらせる	くぐらせる
くぐりぬける	くぐりぬける
くける	くける
くされる	くされる
くじける	くじける
くすねる	くすねる
くすべる	くすべる
くずおれる	くずおれる
くずれおちる	くずれおちる
くずれる	くずれる
くたびれる	くたびれる
くたぶれる	くたぶれる
くだける	くだける
くだされる	くだされる
くだはれる	くだはれる
くちづける	くちづける
くちなれる	くちなれる
くちはてる	くちはてる
くちる	くちる
くっつける	くっつける
くっ付ける	くっ付ける
くつろげる	くつろげる
くどきたてる	くどきたてる
くびれる	くびれる
くべる	くべる
くぼめる	くぼめる
くみあげる	くみあげる
くみあわせる	くみあわせる
くみいれる	くみいれる
くみかえる	くみかえる
くみたてる	くみたてる
くみちがえる	くみちがえる
くみとめる	くみとめる
くみふせる	くみふせる
くみわける	くみわける
くもらせる	くもらせる
くゆらせる	くゆらせる
くらべあわせる	くらべあわせる
くらべる	くらべる
くらわせる	くらわせる
くりあげる	くりあげる
くりあわせる	くりあわせる
くりいれる	くりいれる
くりかえる	くりかえる
くりさげる	くりさげる
くりのべる	くりのべる
くりひろげる	くりひろげる
くりよせる	くりよせる
くるしめる	くるしめる
くるめる	くるめる
くるわせる	くるわせる
くれおちる	くれおちる
くれはてる	くれはてる
くれる	くれる
くろめる	くろめる
くわえる	くわえる
くわせる	くわせる
くわだてる	くわだてる
くわれる	くわれる
くんじる	くんじる
ぐれる	ぐれる
けあげる	けあげる
けいとうだてる	けいとうだてる
けおされる	けおされる
けがれる	けがれる
けごみる	けごみる
けしかける	けしかける
けしとめる	けしとめる
けじめる	けじめる
けずれる	けずれる
けたてる	けたてる
けちがえる	けちがえる
けっしる	けっしる
けっていづける	けっていづける
けつける	けつける
けつろんづける	けつろんづける
けのける	けのける
けりあげる	けりあげる
ける	ける
けんじる	けんじる
げせる	げせる
げびる	げびる
げんきづける	げんきづける
げんじる	げんじる
こいうける	こいうける
こいこがれる	こいこがれる
こいそめる	こいそめる
こいる	こいる
こうじはてる	こうじはてる
こうじる	こうじる
こえる	こえる
こがくれる	こがくれる
こがれる	こがれる
こきまぜる	こきまぜる
こぎえる	こぎえる
こぎつける	こぎつける
こぎぬける	こぎぬける
こぎみる	こぎみる
こぎよせる	こぎよせる
こける	こける
こげる	こげる
こころえる	こころえる
こころがける	こころがける
こころづける	こころづける
こころみる	こころみる
こごえはてる	こごえはてる
こごえる	こごえる
こごめる	こごめる
こさえる	こさえる
こしかける	こしかける
こしらえる	こしらえる
こじあける	こじあける
こじいれる	こじいれる
こじける	こじける
こじつける	こじつける
こじゃれる	こじゃれる
こじらせる	こじらせる
こじる	こじる
こじれる	こじれる
こすりあげる	こすりあげる
こすりつける	こすりつける
こすれる	こすれる
こそげる	こそげる
こたえる	こたえる
こときれる	こときれる
ことたりる	ことたりる
ことづける	ことづける
ことよせる	ことよせる
こどもじみる	こどもじみる
こなれる	こなれる
こねあげる	こねあげる
こねあわせる	こねあわせる
こねる	こねる
こびる	こびる
こぼれおちる	こぼれおちる
こぼれる	こぼれる
こまさくれる	こまさくれる
こましゃくれる	こましゃくれる
こまずける	こまずける
こませる	こませる
こまちゃくれる	こまちゃくれる
こまっしゃくれる	こまっしゃくれる
こまっちゃくれる	こまっちゃくれる
こまりはてる	こまりはてる
こみあげる	こみあげる
こめる	こめる
こらえる	こらえる
こらしめる	こらしめる
こりる	こりる
これる	これる
ころがりおちる	ころがりおちる
ころげおちる	ころげおちる
ころげる	ころげる
こわれる	こわれる
こんじる	こんじる
ごうじみる	ごうじみる
ごてる	ごてる
ごねる	ごねる
ごろうじる	ごろうじる
さいはじける	さいはじける
さえる	さえる
さかえる	さかえる
さかだてる	さかだてる
さがしあぐねる	さがしあぐねる
さがしあてる	さがしあてる
さがしもとめる	さがしもとめる
さきおくれる	さきおくれる
さきがける	さきがける
さきこぼれる	さきこぼれる
さきそめる	さきそめる
さきだてる	さきだてる
さきみだれる	さきみだれる
さきんじる	さきんじる
さぐりあてる	さぐりあてる
さける	さける
さげる	さげる
ささえる	ささえる
ささくれる	ささくれる
ささける	ささける
ささげる	ささげる
さしあげる	さしあげる
さしあてる	さしあてる
さしいれる	さしいれる
さしおさえる	さしおさえる
さしかえる	さしかえる
さしかける	さしかける
さしかためる	さしかためる
さしくわえる	さしくわえる
さしこえる	さしこえる
さしこめる	さしこめる
さしそえる	さしそえる
さしたてる	さしたてる
さしちがえる	さしちがえる
さしつかえる	さしつかえる
さしつける	さしつける
さしでる	さしでる
さしとめる	さしとめる
さしのべる	さしのべる
さしひかえる	さしひかえる
さしむける	さしむける
さしもつれる	さしもつれる
さずける	さずける
させる	させる
さそいあわせる	さそいあわせる
さそいかける	さそいかける
さだめる	さだめる
さっしる	さっしる
さとなれる	さとなれる
さばける	さばける
さびる	さびる
さびれる	さびれる
さまたげる	さまたげる
さめる	さめる
さらえる	さらえる
さらけやめる	さらけやめる
さらける	さらける
さらけ止める	さらけ止める
さらばえる	さらばえる
される	される
さわがせる	さわがせる
さわぎたてる	さわぎたてる
さんじる	さんじる
ざれる	ざれる
しあげる	しあげる
しいたげる	しいたげる
しいつける	しいつける
しいる	しいる
しいれる	しいれる
しえたげる	しえたげる
しおえる	しおえる
しおおせる	しおおせる
しおたれる	しおたれる
しおれる	しおれる
しかえる	しかえる
しかける	しかける
しかねる	しかねる
しかめる	しかめる
しからしめる	しからしめる
しかりつける	しかりつける
しきつめる	しきつめる
しぐれる	しぐれる
しける	しける
しこためる	しこためる
しずめる	しずめる
しそんじる	しそんじる
したがえる	したがえる
したためる	したためる
したたりおちる	したたりおちる
したてあげる	したてあげる
したてる	したてる
したぶれる	したぶれる
しだれる	しだれる
しちがえる	しちがえる
しっける	しっける
しつける	しつける
しつらえる	しつらえる
しとげる	しとげる
しとめる	しとめる
しなえる	しなえる
しなだれる	しなだれる
しなびる	しなびる
しなれる	しなれる
しにおくれる	しにおくれる
しにかける	しにかける
しにきれる	しにきれる
しにたえる	しにたえる
しにはてる	しにはてる
しにわかれる	しにわかれる
しのばせる	しのばせる
しはてる	しはてる
しばいじみる	しばいじみる
しばきあげる	しばきあげる
しばみる	しばみる
しばりあげる	しばりあげる
しばりつける	しばりつける
しばれる	しばれる
しびれる	しびれる
しほうける	しほうける
しぼりあげる	しぼりあげる
しまいつける	しまいつける
しまいわすれる	しまいわすれる
しみたれる	しみたれる
しみったれる	しみったれる
しみでる	しみでる
しみる	しみる
しみわれる	しみわれる
しむける	しむける
しめあげる	しめあげる
しめしあわせる	しめしあわせる
しめつける	しめつける
しめよせる	しめよせる
しめる	しめる
しもがれる	しもがれる
しもげる	しもげる
しゃがれる	しゃがれる
しゃくりあげる	しゃくりあげる
しゃくれる	しゃくれる
しゃしゃりでる	しゃしゃりでる
しゃしゃり出る	しゃしゃり出る
しゃばりでる	しゃばりでる
しゃばり出る	しゃばり出る
しゃべりたてる	しゃべりたてる
しゃべりつける	しゃべりつける
しゃれる	しゃれる
しょうこだてる	しょうこだてる
しょうじいれる	しょうじいれる
しょうじる	しょうじる
しょくすぎる	しょくすぎる
しょげる	しょげる
しょしめる	しょしめる
しょたいじみる	しょたいじみる
しょってる	しょってる
しょぼくれる	しょぼくれる
しょぼたれる	しょぼたれる
しょぼぬれる	しょぼぬれる
しょぼ濡れる	しょぼ濡れる
しらける	しらける
しらげる	しらげる
しらせる	しらせる
しらちゃける	しらちゃける
しらっぱくれる	しらっぱくれる
しらばくれる	しらばくれる
しらばっくれる	しらばっくれる
しらべあげる	しらべあげる
しらべる	しらべる
しりそめる	しりそめる
しりぞける	しりぞける
しれる	しれる
しわがれる	しわがれる
しわける	しわける
しわだてる	しわだてる
しわびる	しわびる
しわめる	しわめる
しんじる	しんじる
しんぜる	しんぜる
じくねる	じくねる
じゃみる	じゃみる
じゃらける	じゃらける
じゃれる	じゃれる
じゅんじょだてる	じゅんじょだてる
じゅんじる	じゅんじる
じょうける	じょうける
じょうじる	じょうじる
じょうびる	じょうびる
じれる	じれる
すいあげる	すいあげる
すいいれる	すいいれる
すいつける	すいつける
すいよせる	すいよせる
すえつける	すえつける
すえる	すえる
すかしみる	すかしみる
すがめる	すがめる
すがれる	すがれる
すぎる	すぎる
すくいあげる	すくいあげる
すくめる	すくめる
すぐれる	すぐれる
すける	すける
すげかえる	すげかえる
すげる	すげる
すこびる	すこびる
すじだてる	すじだてる
すすける	すすける
すすびる	すすびる
すすぼける	すすぼける
すすみでる	すすみでる
すすめる	すすめる
すすりあげる	すすりあげる
すたれる	すたれる
すっこめる	すっこめる
すっとぼける	すっとぼける
すっぽぬける	すっぽぬける
すっぽ抜ける	すっぽ抜ける
すっ込める	すっ込める
すてる	すてる
すねる	すねる
すばける	すばける
すべりおちる	すべりおちる
すべりでる	すべりでる
すべる	すべる
すぼける	すぼける
すぼめる	すぼめる
すませる	すませる
すみかえる	すみかえる
すみなれる	すみなれる
すみわける	すみわける
すみわびる	すみわびる
すりあげる	すりあげる
すりあわせる	すりあわせる
すりかえる	すりかえる
すりきれる	すりきれる
すりつける	すりつける
すりぬける	すりぬける
すりむける	すりむける
すれる	すれる
ずっこける	ずっこける
ずぬける	ずぬける
ずばぬける	ずばぬける
ずば抜ける	ずば抜ける
ずりおちる	ずりおちる
ずり落ちる	ずり落ちる
ずるける	ずるける
ずるっこける	ずるっこける
ずれる	ずれる
せかせる	せかせる
せがみたてる	せがみたてる
せがみ立てる	せがみ立てる
せきあう	せきあう
せきあげる	せきあげる
せきたてる	せきたてる
せきとめる	せきとめる
せぐりあげる	せぐりあげる
せぐり上げる	せぐり上げる
せこめる	せこめる
せしめる	せしめる
せたげる	せたげる
せっしる	せっしる
せばめる	せばめる
せめかける	せめかける
せめたてる	せめたてる
せめつける	せめつける
せめよせる	せめよせる
せめる	せめる
せりあげる	せりあげる
せりたてる	せりたてる
せりつめる	せりつめる
せりまける	せりまける
せんじつめる	せんじつめる
せんじる	せんじる
そいとげる	そいとげる
そえる	そえる
そげおちる	そげおちる
そげる	そげる
そこねる	そこねる
そそくれる	そそくれる
そそける	そそける
そそりたてる	そそりたてる
そそり立てる	そそり立てる
そだてあげる	そだてあげる
そだてる	そだてる
そなえつける	そなえつける
そなえる	そなえる
そばえる	そばえる
そばだてる	そばだてる
そばめる	そばめる
そびえる	そびえる
そびれる	そびれる
そぼぬれる	そぼぬれる
そぼ濡れる	そぼ濡れる
そむける	そむける
そめあげる	そめあげる
そめかえる	そめかえる
そめつける	そめつける
そめる	そめる
そめわける	そめわける
そらっとぼける	そらっとぼける
そらとぼける	そらとぼける
そらんじる	そらんじる
そりあげる	そりあげる
そりさげる	そりさげる
それる	それる
そろえる	そろえる
そわせる	そわせる
そんじる	そんじる
ぞける	ぞける
ぞんじあげる	ぞんじあげる
ぞんじる	ぞんじる
たいじる	たいじる
たいらげる	たいらげる
たえかねる	たえかねる
たえはてる	たえはてる
たえる	たえる
たおれる	たおれる
たかめる	たかめる
たがえる	たがえる
たがねる	たがねる
たきこめる	たきこめる
たきしめる	たきしめる
たきつける	たきつける
たくしあげる	たくしあげる
たくしかける	たくしかける
たくし上げる	たくし上げる
たくれる	たくれる
たくわえる	たくわえる
たぐえる	たぐえる
たぐりあげる	たぐりあげる
たぐりよせる	たぐりよせる
たける	たける
たしあわせる	たしあわせる
たしかめる	たしかめる
たしなめる	たしなめる
たじれる	たじれる
たすける	たすける
たずさえる	たずさえる
たずねあてる	たずねあてる
たずねあわせる	たずねあわせる
たずねる	たずねる
たそがれる	たそがれる
たたえる	たたえる
たたきあげる	たたきあげる
たたきたてる	たたきたてる
たたきつける	たたきつける
たたきふせる	たたきふせる
たたみあげる	たたみあげる
たたみかける	たたみかける
ただれる	ただれる
たちあげる	たちあげる
たちあらわれる	たちあらわれる
たちあわせる	たちあわせる
たちいる	たちいる
たちおくれる	たちおくれる
たちがれる	たちがれる
たちきれる	たちきれる
たちぎえる	たちぎえる
たちくたびれる	たちくたびれる
たちこえる	たちこえる
たちこめる	たちこめる
たちつづける	たちつづける
たちみる	たちみる
たちわかれる	たちわかれる
たっしる	たっしる
たてかえる	たてかえる
たてかける	たてかける
たてこめる	たてこめる
たてつける	たてつける
たてならべる	たてならべる
たてる	たてる
たでる	たでる
たとえる	たとえる
たのしませる	たのしませる
たばねる	たばねる
たびなれる	たびなれる
たべかける	たべかける
たべくらべる	たべくらべる
たべすぎる	たべすぎる
たべつける	たべつける
たべる	たべる
たべれる	たべれる
たまげる	たまげる
たまりかねる	たまりかねる
たむける	たむける
ためる	ためる
たりる	たりる
たるめる	たるめる
たれこめる	たれこめる
たれる	たれる
たわける	たわける
たわぶれる	たわぶれる
たわむれる	たわむれる
たわめる	たわめる
たんじる	たんじる
たんねる	たんねる
だきあげる	だきあげる
だきあわせる	だきあわせる
だきいれる	だきいれる
だきかかえる	だきかかえる
だきしめる	だきしめる
だきすくめる	だきすくめる
だきとめる	だきとめる
だきよせる	だきよせる
だしおくれる	だしおくれる
だだける	だだける
だらける	だらける
だりむくれる	だりむくれる
だれる	だれる
だんじつける	だんじつける
だんじる	だんじる
ちかづける	ちかづける
ちかよせる	ちかよせる
ちからづける	ちからづける
ちがえる	ちがえる
ちぎれる	ちぎれる
ちぢくれる	ちぢくれる
ちぢける	ちぢける
ちぢこめる	ちぢこめる
ちぢめる	ちぢめる
ちぢらせる	ちぢらせる
ちぢれる	ちぢれる
ちつじょだてる	ちつじょだてる
ちびる	ちびる
ちゃらける	ちゃらける
ちょうける	ちょうける
ちょうじあわせる	ちょうじあわせる
ちょうじる	ちょうじる
ちょちょぎれる	ちょちょぎれる
ちょちょ切れる	ちょちょ切れる
ちょんぎれる	ちょんぎれる
ちょん切れる	ちょん切れる
ちらつかせる	ちらつかせる
ちりそめる	ちりそめる
ちりばめる	ちりばめる
ちりみだれる	ちりみだれる
ちんじる	ちんじる
ついいる	ついいる
ついえる	ついえる
ついてる	ついてる
ついでる	ついでる
つい居る	つい居る
つうじる	つうじる
つえる	つえる
つかいつける	つかいつける
つかいなれる	つかいなれる
つかいわける	つかいわける
つかえる	つかえる
つかねる	つかねる
つかまえる	つかまえる
つかませる	つかませる
つかれはてる	つかれはてる
つかれる	つかれる
つかわされる	つかわされる
つがえる	つがえる
つきあげる	つきあげる
つきあてる	つきあてる
つきあわせる	つきあわせる
つきいれる	つきいれる
つきかける	つきかける
つきかためる	つきかためる
つきすえる	つきすえる
つきたてる	つきたてる
つきつける	つきつける
つきつめる	つきつめる
つきでる	つきでる
つきとめる	つきとめる
つきなみる	つきなみる
つきぬける	つきぬける
つきのける	つきのける
つきはてる	つきはてる
つきまぜる	つきまぜる
つきる	つきる
つぎあわせる	つぎあわせる
つぎたてる	つぎたてる
つくねる	つくねる
つくりあげる	つくりあげる
つくりあわせる	つくりあわせる
つくりかえる	つくりかえる
つくりたてる	つくりたてる
つくりつける	つくりつける
つけあわせる	つけあわせる
つけかえる	つけかえる
つけくわえる	つけくわえる
つけそえる	つけそえる
つける	つける
つげしらせる	つげしらせる
つげる	つげる
つたえうける	つたえうける
つたえる	つたえる
つっかえる	つっかえる
つっかける	つっかける
つっくるめる	つっくるめる
つったてる	つったてる
つっぱねる	つっぱねる
つづける	つづける
つづめる	つづめる
つづりあわせる	つづりあわせる
つとめあげる	つとめあげる
つとめる	つとめる
つなぎとめる	つなぎとめる
つなげる	つなげる
つばめる	つばめる
つぶれる	つぶれる
つぼめる	つぼめる
つまされる	つまされる
つまだてる	つまだてる
つみあげる	つみあげる
つみかえる	つみかえる
つみかさねる	つみかさねる
つみたてる	つみたてる
つめあわせる	つめあわせる
つめかえる	つめかえる
つめかける	つめかける
つめよせる	つめよせる
つめる	つめる
つよめる	つよめる
つらねる	つらねる
つらまえる	つらまえる
つられる	つられる
つりあげる	つりあげる
つりさげる	つりさげる
つるしあげる	つるしあげる
つるべかける	つるべかける
つれる	つれる
つんでる	つんでる
つん出る	つん出る
てがける	てがける
てこねる	てこねる
てずれる	てずれる
てづかえる	てづかえる
てなずける	てなずける
てなれる	てなれる
てびかえる	てびかえる
てまえる	てまえる
てらしあわせる	てらしあわせる
てりあわせる	てりあわせる
てりつける	てりつける
てりはえる	てりはえる
てれる	てれる
てんじる	てんじる
でおくれる	でおくれる
でかける	でかける
できすぎる	できすぎる
できる	できる
でける	でける
ですぎる	ですぎる
でっくわせる	でっくわせる
でっちあげる	でっちあげる
でっちる	でっちる
でぬける	でぬける
ではずれる	ではずれる
ではなれる	ではなれる
でむかえる	でむかえる
でる	でる
でれる	でれる
といあわせる	といあわせる
といかける	といかける
といつめる	といつめる
とうじる	とうじる
とおざける	とおざける
とおのける	とおのける
とおりあわせる	とおりあわせる
とおりすぎる	とおりすぎる
とおりぬける	とおりぬける
とかまえる	とかまえる
とがめる	とがめる
ときあきらめる	ときあきらめる
とききかせる	とききかせる
ときすすめる	ときすすめる
ときつける	ときつける
ときふせる	ときふせる
ときわける	ときわける
とぎあげる	とぎあげる
とぎらせる	とぎらせる
とぎれる	とぎれる
とくしょくづける	とくしょくづける
とくちょうづける	とくちょうづける
とける	とける
とげる	とげる
としおいる	としおいる
としたける	としたける
としよりじみる	としよりじみる
とじあわせる	とじあわせる
とじこめる	とじこめる
とじつける	とじつける
とじる	とじる
とだえる	とだえる
とっかえる	とっかえる
とっちめる	とっちめる
とっちる	とっちる
とっつかまえる	とっつかまえる
ととのえる	ととのえる
とどけでる	とどけでる
とどける	とどける
とどめる	とどめる
となえる	となえる
とびおきる	とびおきる
とびおりる	とびおりる
とびこえる	とびこえる
とびでる	とびでる
とびぬける	とびぬける
とびはなれる	とびはなれる
とびはねる	とびはねる
とぼける	とぼける
とめる	とめる
とらえる	とらえる
とらせる	とらせる
とらまえる	とらまえる
とらわれる	とらわれる
とりあげる	とりあげる
とりあつめる	とりあつめる
とりあわせる	とりあわせる
とりいる	とりいる
とりいれる	とりいれる
とりおさえる	とりおさえる
とりおさめる	とりおさめる
とりかえる	とりかえる
とりかける	とりかける
とりかたづける	とりかたづける
とりかためる	とりかためる
とりきめる	とりきめる
とりこめる	とりこめる
とりさげる	とりさげる
とりしずめる	とりしずめる
とりしらべる	とりしらべる
とりすてる	とりすてる
とりそえる	とりそえる
とりそろえる	とりそろえる
とりたてる	とりたてる
とりちがえる	とりちがえる
とりつかれる	とりつかれる
とりつける	とりつける
とりつめる	とりつめる
とりとめる	とりとめる
とりならべる	とりならべる
とりのける	とりのける
とりのぼせる	とりのぼせる
とりひろげる	とりひろげる
とりまぎれる	とりまぎれる
とりまぜる	とりまぜる
とりまとめる	とりまとめる
とりみだれる	とりみだれる
とりみる	とりみる
とりやめる	とりやめる
とりよせる	とりよせる
とりわける	とりわける
とりわすれる	とりわすれる
とれる	とれる
とろける	とろける
どうける	どうける
どうじる	どうじる
どける	どける
どなりたてる	どなりたてる
どなりつける	どなりつける
どはずれる	どはずれる
どまくれる	どまくれる
どまぐれる	どまぐれる
どやしつける	どやしつける
どれる	どれる
ないあわせる	ないあわせる
ないまぜる	ないまぜる
なえる	なえる
なかせる	なかせる
ながめる	ながめる
ながらえる	ながらえる
ながれおちる	ながれおちる
ながれでる	ながれでる
ながれる	ながれる
なきくずれる	なきくずれる
なきたてる	なきたてる
なきぬれる	なきぬれる
なきわかれる	なきわかれる
なぎたてる	なぎたてる
なぎふせる	なぎふせる
なぐさめる	なぐさめる
なぐりつける	なぐりつける
なぐれる	なぐれる
なける	なける
なげいれる	なげいれる
なげかける	なげかける
なげすてる	なげすてる
なげつける	なげつける
なげる	なげる
なごめる	なごめる
なされる	なされる
なしとげる	なしとげる
なしゃれる	なしゃれる
なすりつける	なすりつける
なずける	なずける
なずらえる	なずらえる
なぜる	なぜる
なぞらえる	なぞらえる
なだめる	なだめる
なだれおちる	なだれおちる
なだれる	なだれる
なつける	なつける
なづける	なづける
なであげる	なであげる
なでつける	なでつける
なでる	なでる
なのりでる	なのりでる
なびける	なびける
なまける	なまける
なみいる	なみいる
なみはずれる	なみはずれる
なめる	なめる
なやめる	なやめる
ならべかえる	ならべかえる
ならべたてる	ならべたてる
ならべる	ならべる
なりおおせる	なりおおせる
なりはてる	なりはてる
なれそめる	なれそめる
なれる	なれる
なんじる	なんじる
にあげる	にあげる
にあわせる	にあわせる
にえこぼれる	にえこぼれる
にえる	にえる
においこぼれる	においこぼれる
におわせる	におわせる
にがめる	にがめる
にぎらせる	にぎらせる
にぎりしめる	にぎりしめる
にぎりつめる	にぎりつめる
にげうせる	にげうせる
にげおおせる	にげおおせる
にげおくれる	にげおくれる
にげおちる	にげおちる
にげかくれる	にげかくれる
にげのびる	にげのびる
にげる	にげる
にこぼれる	にこぼれる
にしめる	にしめる
にじませる	にじませる
にじみでる	にじみでる
にじりでる	にじりでる
にせる	にせる
にたたせる	にたたせる
にたてる	にたてる
にちる	にちる
につける	につける
につめる	につめる
にふくめる	にふくめる
にやける	にやける
にらまえる	にらまえる
にらみあわせる	にらみあわせる
にらみすえる	にらみすえる
にらみつける	にらみつける
にらめつける	にらめつける
にらめる	にらめる
にる	にる
にんじる	にんじる
ぬいあげる	ぬいあげる
ぬいあわせる	ぬいあわせる
ぬいいれる	ぬいいれる
ぬいつける	ぬいつける
ぬきあわせる	ぬきあわせる
ぬきつれる	ぬきつれる
ぬきでる	ぬきでる
ぬきんでる	ぬきんでる
ぬぎかえる	ぬぎかえる
ぬぎかける	ぬぎかける
ぬぎすてる	ぬぎすてる
ぬくめる	ぬくめる
ぬけおちる	ぬけおちる
ぬけでる	ぬけでる
ぬける	ぬける
ぬげる	ぬげる
ぬすみみる	ぬすみみる
ぬりあげる	ぬりあげる
ぬりかえる	ぬりかえる
ぬりかためる	ぬりかためる
ぬりこめる	ぬりこめる
ぬりたてる	ぬりたてる
ぬりつける	ぬりつける
ぬるめる	ぬるめる
ぬれしょぼたれる	ぬれしょぼたれる
ぬれる	ぬれる
ねあきる	ねあきる
ねかしつける	ねかしつける
ねかせる	ねかせる
ねがいあげる	ねがいあげる
ねがいさげる	ねがいさげる
ねがいでる	ねがいでる
ねくたれる	ねくたれる
ねざめる	ねざめる
ねじあける	ねじあける
ねじあげる	ねじあげる
ねじくれる	ねじくれる
ねじける	ねじける
ねじつける	ねじつける
ねじふせる	ねじふせる
ねじまげる	ねじまげる
ねじむける	ねじむける
ねじりあげる	ねじりあげる
ねじる	ねじる
ねじれる	ねじれる
ねすぎる	ねすぎる
ねせつける	ねせつける
ねせる	ねせる
ねそびれる	ねそびれる
ねたおれる	ねたおれる
ねだれる	ねだれる
ねちがえる	ねちがえる
ねとぼける	ねとぼける
ねはぐれる	ねはぐれる
ねはれる	ねはれる
ねほれる	ねほれる
ねぼける	ねぼける
ねみだれる	ねみだれる
ねむらせる	ねむらせる
ねむりこける	ねむりこける
ねめつける	ねめつける
ねめる	ねめる
ねらいさだめる	ねらいさだめる
ねりあげる	ねりあげる
ねりあわせる	ねりあわせる
ねりかためる	ねりかためる
ねる	ねる
ねれける	ねれける
ねれる	ねれる
ねわすれる	ねわすれる
ねんがける	ねんがける
ねんじる	ねんじる
のがれる	のがれる
のける	のける
のしあげる	のしあげる
のせかける	のせかける
のせる	のせる
のぞかせる	のぞかせる
のぞきみる	のぞきみる
のぞける	のぞける
のぞみみる	のぞみみる
のっける	のっける
のびる	のびる
のべたてる	のべたてる
のべみる	のべみる
のべる	のべる
のぼせる	のぼせる
のぼりつめる	のぼりつめる
のませる	のませる
のみかける	のみかける
のみつける	のみつける
のみつぶれる	のみつぶれる
のめる	のめる
のりあげる	のりあげる
のりあわせる	のりあわせる
のりいれる	のりいれる
のりおくれる	のりおくれる
のりかえる	のりかえる
のりかける	のりかける
のりこえる	のりこえる
のりしずめる	のりしずめる
のりすてる	のりすてる
のりつける	のりつける
のりつづける	のりつづける
のりなれる	のりなれる
のろける	のろける
のんだくれる	のんだくれる
はいでる	はいでる
はえつける	はえつける
はえでる	はえでる
はえる	はえる
はかりかねる	はかりかねる
はがれる	はがれる
はきかえる	はきかえる
はききよめる	はききよめる
はきすてる	はきすてる
はきちがえる	はきちがえる
はきよせる	はきよせる
はぎあわせる	はぎあわせる
はぐれる	はぐれる
はける	はける
はげおちる	はげおちる
はげちょろける	はげちょろける
はげる	はげる
はさみいれる	はさみいれる
はしける	はしける
はしらせる	はしらせる
はしりすぎる	はしりすぎる
はしりぬける	はしりぬける
はじける	はじける
はじしめる	はじしめる
はじめる	はじめる
はじる	はじる
はずかしめる	はずかしめる
はずませる	はずませる
はずれる	はずれる
はせさんじる	はせさんじる
はせつける	はせつける
はせる	はせる
はぜる	はぜる
はたらかせる	はたらかせる
はたらきかける	はたらきかける
はだける	はだける
はちきれる	はちきれる
はち切れる	はち切れる
はっちゃける	はっちゃける
はてる	はてる
はなしかける	はなしかける
はなせる	はなせる
はなひる	はなひる
はなれる	はなれる
はねあげる	はねあげる
はねおきる	はねおきる
はねかける	はねかける
はねつける	はねつける
はねのける	はねのける
はねる	はねる
はみでる	はみでる
はめる	はめる
はやしたてる	はやしたてる
はやめる	はやめる
はやらせる	はやらせる
はらいあげる	はらいあげる
はらいきよめる	はらいきよめる
はらいさげる	はらいさげる
はらいのける	はらいのける
はらだてる	はらだてる
はりあげる	はりあげる
はりあわせる	はりあわせる
はりかえる	はりかえる
はりきれる	はりきれる
はりさける	はりさける
はりつける	はりつける
はりつめる	はりつめる
はれる	はれる
はんじる	はんじる
ばえる	ばえる
ばかげる	ばかげる
ばける	ばける
ばしゃれる	ばしゃれる
ばっくれる	ばっくれる
ばてる	ばてる
ばなれる	ばなれる
ばらける	ばらける
ばれる	ばれる
ばんじる	ばんじる
ぱちつかせる	ぱちつかせる
ひいでる	ひいでる
ひえる	ひえる
ひかえる	ひかえる
ひかされる	ひかされる
ひからせる	ひからせる
ひからびる	ひからびる
ひきあける	ひきあける
ひきあげる	ひきあげる
ひきあてる	ひきあてる
ひきあわせる	ひきあわせる
ひきいる	ひきいる
ひきいれる	ひきいれる
ひきうける	ひきうける
ひきかえる	ひきかえる
ひきかける	ひきかける
ひきくらべる	ひきくらべる
ひきくるめる	ひきくるめる
ひきこめる	ひきこめる
ひきさげる	ひきさげる
ひきしめる	ひきしめる
ひきすえる	ひきすえる
ひきそろえる	ひきそろえる
ひきたてる	ひきたてる
ひきちがえる	ひきちがえる
ひきつける	ひきつける
ひきつめる	ひきつめる
ひきつれる	ひきつれる
ひきとどめる	ひきとどめる
ひきとめる	ひきとめる
ひきのける	ひきのける
ひきよせる	ひきよせる
ひきわける	ひきわける
ひくめる	ひくめる
ひける	ひける
ひこつかせる	ひこつかせる
ひさげる	ひさげる
ひしげる	ひしげる
ひしゃげる	ひしゃげる
ひそめる	ひそめる
ひっかかえる	ひっかかえる
ひっかける	ひっかける
ひっからげる	ひっからげる
ひっくるめる	ひっくるめる
ひっこめる	ひっこめる
ひっさげる	ひっさげる
ひったてる	ひったてる
ひっつかまえる	ひっつかまえる
ひっつける	ひっつける
ひっつめる	ひっつめる
ひっとらえる	ひっとらえる
ひっぱりあげる	ひっぱりあげる
ひとなれる	ひとなれる
ひとりごちる	ひとりごちる
ひなびる	ひなびる
ひねくれる	ひねくれる
ひねこびる	ひねこびる
ひねる	ひねる
ひびかせる	ひびかせる
ひびれる	ひびれる
ひびわれる	ひびわれる
ひめる	ひめる
ひもづける	ひもづける
ひやける	ひやける
ひょうげる	ひょうげる
ひょろける	ひょろける
ひらける	ひらける
ひらめる	ひらめる
ひる	ひる
ひろいあげる	ひろいあげる
ひろげる	ひろげる
ひろめる	ひろめる
ひわれる	ひわれる
ひんまげる	ひんまげる
ひん曲げる	ひん曲げる
ふうじこめる	ふうじこめる
ふうじる	ふうじる
ふえる	ふえる
ふかせる	ふかせる
ふかめる	ふかめる
ふきあげる	ふきあげる
ふきあつめる	ふきあつめる
ふきあれる	ふきあれる
ふきいれる	ふきいれる
ふきかえる	ふきかえる
ふきかける	ふきかける
ふきこぼれる	ふきこぼれる
ふきたてる	ふきたてる
ふきつける	ふきつける
ふきでる	ふきでる
ふきぬける	ふきぬける
ふきよせる	ふきよせる
ふきわける	ふきわける
ふくめる	ふくめる
ふくらせる	ふくらせる
ふくらめる	ふくらめる
ふくれる	ふくれる
ふける	ふける
ふさげる	ふさげる
ふざける	ふざける
ふすべる	ふすべる
ふせる	ふせる
ふっかける	ふっかける
ふっきれる	ふっきれる
ふてくされる	ふてくされる
ふてる	ふてる
ふぬける	ふぬける
ふまえる	ふまえる
ふみいれる	ふみいれる
ふみかえる	ふみかえる
ふみかためる	ふみかためる
ふみこえる	ふみこえる
ふみこたえる	ふみこたえる
ふみしめる	ふみしめる
ふみたてる	ふみたてる
ふみちがえる	ふみちがえる
ふみつける	ふみつける
ふみはだける	ふみはだける
ふみわける	ふみわける
ふやける	ふやける
ふゆがれる	ふゆがれる
ふらせる	ふらせる
ふられる	ふられる
ふりあげる	ふりあげる
ふりあてる	ふりあてる
ふりかえる	ふりかえる
ふりかける	ふりかける
ふりきれる	ふりきれる
ふりこめる	ふりこめる
ふりさけみる	ふりさけみる
ふりすてる	ふりすてる
ふりたてる	ふりたてる
ふりつける	ふりつける
ふりむける	ふりむける
ふりわける	ふりわける
ふるいわける	ふるいわける
ふるえる	ふるえる
ふるける	ふるける
ふるびる	ふるびる
ふるぼける	ふるぼける
ふるわせる	ふるわせる
ふれる	ふれる
ふんづかまえる	ふんづかまえる
ふんづける	ふんづける
ふんまえる	ふんまえる
ふん捕まえる	ふん捕まえる
ぶしゃれる	ぶしゃれる
ぶちあける	ぶちあける
ぶちあげる	ぶちあげる
ぶちきれる	ぶちきれる
ぶちまける	ぶちまける
ぶっかける	ぶっかける
ぶっきれる	ぶっきれる
ぶったおれる	ぶったおれる
ぶったまげる	ぶったまげる
ぶっちめる	ぶっちめる
ぶっちゃける	ぶっちゃける
ぶっつける	ぶっつける
ぶつける	ぶつける
ぶらさげる	ぶらさげる
ぶら下げる	ぶら下げる
ぶれる	ぶれる
ぶんなげる	ぶんなげる
ぶんむくれる	ぶんむくれる
へがれる	へがれる
へげる	へげる
へこたれる	へこたれる
へしまげる	へしまげる
へしゃげる	へしゃげる
へだてる	へだてる
へる	へる
へんがえる	へんがえる
へんげる	へんげる
へんじる	へんじる
べんじたてる	べんじたてる
べんじつける	べんじつける
べんじる	べんじる
ほうける	ほうける
ほうこうづける	ほうこうづける
ほうじる	ほうじる
ほうりあげる	ほうりあげる
ほうりなげる	ほうりなげる
ほえる	ほえる
ほおける	ほおける
ほぐれる	ほぐれる
ほける	ほける
ほげる	ほげる
ほころばせる	ほころばせる
ほころびる	ほころびる
ほごれる	ほごれる
ほしあげる	ほしあげる
ほしかためる	ほしかためる
ほそめる	ほそめる
ほたえる	ほたえる
ほだされる	ほだされる
ほだてる	ほだてる
ほつれる	ほつれる
ほとびる	ほとびる
ほどける	ほどける
ほどへる	ほどへる
ほのみえる	ほのみえる
ほのみせる	ほのみせる
ほめあげる	ほめあげる
ほめたたえる	ほめたたえる
ほめたてる	ほめたてる
ほめる	ほめる
ほりあげる	ほりあげる
ほりあてる	ほりあてる
ほりさげる	ほりさげる
ほりたてる	ほりたてる
ほりつける	ほりつける
ほれる	ほれる
ほろびる	ほろびる
ぼける	ぼける
ぼっかける	ぼっかける
ぼったてる	ぼったてる
ぼやける	ぼやける
ぼろける	ぼろける
まいおさめる	まいおさめる
まいおちる	まいおちる
まいおりる	まいおりる
まかせる	まかせる
まかりでる	まかりでる
まがえる	まがえる
まきあげる	まきあげる
まきかえる	まきかえる
まきつける	まきつける
まぎらせる	まぎらせる
まぎれる	まぎれる
まくしあげる	まくしあげる
まくしかける	まくしかける
まくしたてる	まくしたてる
まくりあげる	まくりあげる
まくれる	まくれる
まぐれる	まぐれる
まける	まける
まげる	まげる
まじえる	まじえる
ませる	ませる
まぜあわせる	まぜあわせる
まぜる	まぜる
またげる	またげる
またごえる	またごえる
またせる	またせる
まちあぐねる	まちあぐねる
まちあわせる	まちあわせる
まちうける	まちうける
まちかねる	まちかねる
まちかまえる	まちかまえる
まちがえる	まちがえる
まちくたびれる	まちくたびれる
まちこがれる	まちこがれる
まちつける	まちつける
まちぶせる	まちぶせる
まちもうける	まちもうける
まちわびる	まちわびる
まつべる	まつべる
まつめる	まつめる
まつりあげる	まつりあげる
まといる	まといる
まとめあげる	まとめあげる
まとめる	まとめる
まどいる	まどいる
まにあわせる	まにあわせる
まぬかれる	まぬかれる
まぬがれる	まぬがれる
まねきいれる	まねきいれる
まねきよせる	まねきよせる
まねる	まねる
まびれる	まびれる
まぶれる	まぶれる
まみえる	まみえる
まみれる	まみれる
まるめる	まるめる
まろめる	まろめる
まわしいれる	まわしいれる
まわしかける	まわしかける
まんじる	まんじる
みあきる	みあきる
みあげる	みあげる
みあわせる	みあわせる
みうける	みうける
みえる	みえる
みおぼえる	みおぼえる
みかえる	みかえる
みかける	みかける
みかねる	みかねる
みがきあげる	みがきあげる
みがきたてる	みがきたてる
みがまえる	みがまえる
みきれる	みきれる
みきわめる	みきわめる
みくらべる	みくらべる
みさげはてる	みさげはてる
みさげる	みさげる
みさだめる	みさだめる
みすえる	みすえる
みすてる	みすてる
みせかける	みせかける
みせつける	みせつける
みせる	みせる
みそめる	みそめる
みそれる	みそれる
みそんじる	みそんじる
みぞれる	みぞれる
みたてる	みたてる
みだれる	みだれる
みちあふれる	みちあふれる
みちがえる	みちがえる
みちたりる	みちたりる
みちみちる	みちみちる
みちる	みちる
みつける	みつける
みつめる	みつめる
みとがめる	みとがめる
みとどける	みとどける
みとめる	みとめる
みとれる	みとれる
みなれる	みなれる
みはぐれる	みはぐれる
みはてる	みはてる
みほれる	みほれる
みまちがえる	みまちがえる
みみなれる	みみなれる
みもだえる	みもだえる
みやこびる	みやこびる
みやびる	みやびる
みる	みる
みれる	みれる
みわける	みわける
みわすれる	みわすれる
むかいあわせる	むかいあわせる
むかえいれる	むかえいれる
むかえる	むかえる
むくいる	むくいる
むくれる	むくれる
むけかえる	むけかえる
むける	むける
むすばれる	むすばれる
むすびあわせる	むすびあわせる
むすびつける	むすびつける
むすぼれる	むすぼれる
むせる	むせる
むつける	むつける
むれる	むれる
めあわせる	めあわせる
めいじる	めいじる
めがける	めがける
めくれる	めくれる
めぐまれる	めぐまれる
めぐりあわせる	めぐりあわせる
めげる	めげる
めされる	めされる
めざめる	めざめる
めしあげる	めしあげる
めしいる	めしいる
めしかえる	めしかえる
めしかかえる	めしかかえる
めしつれる	めしつれる
めしよせる	めしよせる
めっける	めっける
めでる	めでる
めなれる	めなれる
めばえる	めばえる
めんじる	めんじる
もうける	もうける
もうしあげる	もうしあげる
もうしあわせる	もうしあわせる
もうしいでる	もうしいでる
もうしいれる	もうしいれる
もうしうける	もうしうける
もうしおくれる	もうしおくれる
もうしかねる	もうしかねる
もうしきかせる	もうしきかせる
もうしきける	もうしきける
もうしそえる	もうしそえる
もうしたてる	もうしたてる
もうしつける	もうしつける
もうしつたえる	もうしつたえる
もうしでる	もうしでる
もうしのべる	もうしのべる
もうでる	もうでる
もえつきる	もえつきる
もえでる	もえでる
もえる	もえる
もぎれる	もぎれる
もげる	もげる
もじれる	もじれる
もたげる	もたげる
もたせかける	もたせかける
もたせる	もたせる
もたれる	もたれる
もだえる	もだえる
もちあげる	もちあげる
もちあわせる	もちあわせる
もちいる	もちいる
もちかえる	もちかえる
もちかける	もちかける
もちこたえる	もちこたえる
もちそえる	もちそえる
もちちょうじる	もちちょうじる
もちつける	もちつける
もちゃげる	もちゃげる
もつれる	もつれる
もてる	もてる
もとめる	もとめる
もぬける	もぬける
ものさびる	ものさびる
ものさびれる	ものさびれる
ものたりる	ものたりる
ものなれる	ものなれる
ものみる	ものみる
もみたてる	もみたてる
もめる	もめる
もらいうける	もらいうける
もらいさげる	もらいさげる
もらいためる	もらいためる
もりあげる	もりあげる
もりあわせる	もりあわせる
もりさげる	もりさげる
もりそだてる	もりそだてる
もりたてる	もりたてる
もりつける	もりつける
もれおちる	もれおちる
もれる	もれる
やきあげる	やきあげる
やきすぎる	やきすぎる
やきすてる	やきすてる
やきつける	やきつける
やくだてる	やくだてる
やけうせる	やけうせる
やけおちる	やけおちる
やけきれる	やけきれる
やけただれる	やけただれる
やけだされる	やけだされる
やける	やける
やさぐれる	やさぐれる
やすませる	やすませる
やすめる	やすめる
やすらげる	やすらげる
やすんじる	やすんじる
やせおとろえる	やせおとろえる
やせがれる	やせがれる
やせこける	やせこける
やせさらばえる	やせさらばえる
やせさらぼえる	やせさらぼえる
やせる	やせる
やっつける	やっつける
やってのける	やってのける
やつれる	やつれる
やといいれる	やといいれる
やぶける	やぶける
やぶれる	やぶれる
やみほうける	やみほうける
やめる	やめる
やらせる	やらせる
やられる	やられる
やりあげる	やりあげる
やりおおせる	やりおおせる
やりかえる	やりかえる
やりかける	やりかける
やりこめる	やりこめる
やりすぎる	やりすぎる
やりそんじる	やりそんじる
やりちがえる	やりちがえる
やりつける	やりつける
やりとげる	やりとげる
やりのける	やりのける
やれる	やれる
やわらげる	やわらげる
ゆいあげる	ゆいあげる
ゆいからげる	ゆいからげる
ゆいつける	ゆいつける
ゆうきづける	ゆうきづける
ゆうばえる	ゆうばえる
ゆがめる	ゆがめる
ゆきあわせる	ゆきあわせる
ゆきくれる	ゆきくれる
ゆきすぎる	ゆきすぎる
ゆきちがえる	ゆきちがえる
ゆきつける	ゆきつける
ゆきつめる	ゆきつめる
ゆきみる	ゆきみる
ゆきわかれる	ゆきわかれる
ゆける	ゆける
ゆさぶれる	ゆさぶれる
ゆすぶれる	ゆすぶれる
ゆすりあげる	ゆすりあげる
ゆすりかける	ゆすりかける
ゆすれる	ゆすれる
ゆずりうける	ゆずりうける
ゆだねる	ゆだねる
ゆであげる	ゆであげる
ゆでる	ゆでる
ゆびおりかぞえる	ゆびおりかぞえる
ゆめみる	ゆめみる
ゆられる	ゆられる
ゆりあげる	ゆりあげる
ゆりる	ゆりる
ゆりわける	ゆりわける
ゆるめる	ゆるめる
ゆれる	ゆれる
ゆわいつける	ゆわいつける
ゆわえつける	ゆわえつける
ゆわえる	ゆわえる
よいしれる	よいしれる
よいつぶれる	よいつぶれる
ようだてる	ようだてる
よける	よける
よこたえる	よこたえる
よごれる	よごれる
よじくれる	よじくれる
よじる	よじる
よじれる	よじれる
よせあつめる	よせあつめる
よせあわせる	よせあわせる
よせかける	よせかける
よせつける	よせつける
よせる	よせる
よそえる	よそえる
よどめる	よどめる
よなげる	よなげる
よなれる	よなれる
よばなれる	よばなれる
よばれる	よばれる
よびあげる	よびあげる
よびあつめる	よびあつめる
よびいれる	よびいれる
よびかける	よびかける
よびたてる	よびたてる
よびつける	よびつける
よびつづける	よびつづける
よびつれる	よびつれる
よびとめる	よびとめる
よびなれる	よびなれる
よびむかえる	よびむかえる
よびよせる	よびよせる
よぼける	よぼける
よませる	よませる
よみあげる	よみあげる
よみあわせる	よみあわせる
よみいれる	よみいれる
よみかえる	よみかえる
よみかける	よみかける
よみきかせる	よみきかせる
よみくらべる	よみくらべる
よみすてる	よみすてる
よみたてる	よみたてる
よみちがえる	よみちがえる
よみつける	よみつける
よみなれる	よみなれる
よみまちがえる	よみまちがえる
よめる	よめる
よりあわせる	よりあわせる
よりいる	よりいる
よりわける	よりわける
よれる	よれる
よろける	よろける
よろこばせる	よろこばせる
よわめる	よわめる
よわりはてる	よわりはてる
りくつづける	りくつづける
ろうたける	ろうたける
ろんじる	ろんじる
わいがける	わいがける
わかせる	わかせる
わかれる	わかれる
わがねる	わがねる
わきでる	わきでる
わきまえる	わきまえる
わけあたえる	わけあたえる
わける	わける
わげる	わげる
わすれる	わすれる
わずらわせる	わずらわせる
わにる	わにる
わびる	わびる
わめきたてる	わめきたてる
わらいくずれる	わらいくずれる
わらいこける	わらいこける
わらいころげる	わらいころげる
わらえる	わらえる
わらわせる	わらわせる
わりあてる	わりあてる
わりあわせる	わりあわせる
わりきれる	わりきれる
わりつける	わりつける
わるびれる	わるびれる
われる	われる
わろびれる	わろびれる
上げる	上げる
上せる	上せる
上びる	上びる
上り詰める	上り詰める
上向ける	上向ける
上振れる	上振れる
上気せる	上気せる
下げる	下げる
下される	下される
下はれる	下はれる
下りる	下りる
下り居る	下り居る
下卑る	下卑る
下振れる	下振れる
不洒落る	不洒落る
不貞る	不貞る
不貞腐れる	不貞腐れる
与える	与える
世慣れる	世慣れる
世離れる	世離れる
世馴れる	世馴れる
並べる	並べる
並べ換える	並べ換える
並べ替える	並べ替える
並べ立てる	並べ立てる
並み外れる	並み外れる
並み居る	並み居る
並外れる	並外れる
並居る	並居る
中てる	中てる
丸める	丸める
乗じる	乗じる
乗せる	乗せる
乗せ掛ける	乗せ掛ける
乗っける	乗っける
乗り上げる	乗り上げる
乗り付ける	乗り付ける
乗り入れる	乗り入れる
乗り合せる	乗り合せる
乗り合わせる	乗り合わせる
乗り慣れる	乗り慣れる
乗り捨てる	乗り捨てる
乗り掛ける	乗り掛ける
乗り換える	乗り換える
乗り替える	乗り替える
乗り越える	乗り越える
乗り遅れる	乗り遅れる
乗り静める	乗り静める
乗り馴れる	乗り馴れる
乗上げる	乗上げる
乗付ける	乗付ける
乗入れる	乗入れる
乗合せる	乗合せる
乗合わせる	乗合わせる
乗慣れる	乗慣れる
乗捨てる	乗捨てる
乗掛ける	乗掛ける
乗換える	乗換える
乗替える	乗替える
乗続ける	乗続ける
乗越える	乗越える
乗遅れる	乗遅れる
乗静める	乗静める
乞い受ける	乞い受ける
乱れる	乱れる
乾し上げる	乾し上げる
乾し固める	乾し固める
乾びる	乾びる
乾る	乾る
乾涸びる	乾涸びる
事切れる	事切れる
事寄せる	事寄せる
事足りる	事足りる
亡びる	亡びる
交える	交える
交ぜる	交ぜる
交ぜ合せる	交ぜ合せる
交ぜ合わせる	交ぜ合わせる
享ける	享ける
人慣れる	人慣れる
人馴れる	人馴れる
仄見える	仄見える
仄見せる	仄見せる
仕える	仕える
仕上げる	仕上げる
仕付ける	仕付ける
仕入れる	仕入れる
仕兼ねる	仕兼ねる
仕分ける	仕分ける
仕向ける	仕向ける
仕掛ける	仕掛ける
仕損じる	仕損じる
仕替える	仕替える
仕留める	仕留める
仕立てる	仕立てる
仕立て上げる	仕立て上げる
仕舞ひ付ける	仕舞ひ付ける
仕訳ける	仕訳ける
仕遂げる	仕遂げる
付ける	付ける
付け加える	付け加える
付け合せる	付け合せる
付け合わせる	付け合わせる
付け替える	付け替える
付け添える	付け添える
付加える	付加える
付合せる	付合せる
付合わせる	付合わせる
付替える	付替える
付添える	付添える
代える	代える
仰ぎ見る	仰ぎ見る
仰せられる	仰せられる
仰せ付ける	仰せ付ける
仰せ聞ける	仰せ聞ける
仰のける	仰のける
仰向ける	仰向ける
任じる	任じる
任せる	任せる
企てる	企てる
伏せる	伏せる
休ませる	休ませる
休める	休める
会せる	会せる
会わせる	会わせる
伝える	伝える
伝え受ける	伝え受ける
伸し上げる	伸し上げる
伸びる	伸びる
伸べる	伸べる
似せる	似せる
似る	似る
位置付ける	位置付ける
低める	低める
住み侘びる	住み侘びる
住み慣れる	住み慣れる
住み替える	住み替える
住み馴れる	住み馴れる
住慣れる	住慣れる
住替える	住替える
佐ける	佐ける
作り上げる	作り上げる
作り付ける	作り付ける
作り合せる	作り合せる
作り合わせる	作り合わせる
作り替える	作り替える
作り立てる	作り立てる
併せる	併せる
使い付ける	使い付ける
使い分ける	使い分ける
使い慣れる	使い慣れる
使い馴れる	使い馴れる
使える	使える
例える	例える
侘びる	侘びる
供える	供える
価値付ける	価値付ける
便じる	便じる
信じる	信じる
修める	修める
俯ける	俯ける
俯せる	俯せる
倒ける	倒ける
倒れる	倒れる
借りる	借りる
借り上げる	借り上げる
借り入れる	借り入れる
借り受ける	借り受ける
借り換える	借り換える
借上げる	借上げる
借入れる	借入れる
借受ける	借受ける
借換える	借換える
倦きる	倦きる
倦ねる	倦ねる
倦み疲れる	倦み疲れる
停める	停める
側める	側める
備える	備える
備え付ける	備え付ける
傷める	傷める
傷付ける	傷付ける
傾ける	傾ける
傾げる	傾げる
傾れる	傾れる
傾れ落ちる	傾れ落ちる
働かせる	働かせる
働き掛ける	働き掛ける
優れる	優れる
儲ける	儲ける
元気付ける	元気付ける
充ちる	充ちる
充てる	充てる
先んじる	先んじる
先立てる	先立てる
先駆ける	先駆ける
先駈ける	先駈ける
光らせる	光らせる
免じる	免じる
免れる	免れる
入り乱れる	入り乱れる
入り揚げる	入り揚げる
入り違える	入り違える
入れる	入れる
入れ交ぜる	入れ交ぜる
入れ揚げる	入れ揚げる
入れ換える	入れ換える
入れ替える	入れ替える
入れ混ぜる	入れ混ぜる
入れ違える	入れ違える
入れ雑ぜる	入れ雑ぜる
入乱れる	入乱れる
具える	具える
兼ねる	兼ねる
兼ね備える	兼ね備える
兼備える	兼備える
円める	円める
円居る	円居る
冬枯れる	冬枯れる
冱える	冱える
冱てる	冱てる
冴える	冴える
冷える	冷える
冷ける	冷ける
冷める	冷める
冷やける	冷やける
准える	准える
准じる	准じる
凍える	凍える
凍え果てる	凍え果てる
凍てる	凍てる
凍みる	凍みる
凍み割れる	凍み割れる
凭せる	凭せる
凭せ掛ける	凭せ掛ける
凭れる	凭れる
凹める	凹める
出し遅れる	出し遅れる
出っ会せる	出っ会せる
出で居る	出で居る
出る	出る
出れる	出れる
出外れる	出外れる
出抜ける	出抜ける
出掛ける	出掛ける
出来る	出来る
出来過ぎる	出来過ぎる
出迎える	出迎える
出遅れる	出遅れる
出過ぎる	出過ぎる
出離れる	出離れる
分かれる	分かれる
分ける	分ける
分け与える	分け与える
分れる	分れる
切っ掛ける	切っ掛ける
切り上げる	切り上げる
切り下げる	切り下げる
切り付ける	切り付ける
切り伏せる	切り伏せる
切り分ける	切り分ける
切り広げる	切り広げる
切り抜ける	切り抜ける
切り捨てる	切り捨てる
切り掛ける	切り掛ける
切り揃える	切り揃える
切り換える	切り換える
切り替える	切り替える
切り立てる	切り立てる
切り詰める	切り詰める
切れる	切れる
切上げる	切上げる
切下げる	切下げる
切付ける	切付ける
切伏せる	切伏せる
切分ける	切分ける
切広げる	切広げる
切抜ける	切抜ける
切捨てる	切捨てる
切掛ける	切掛ける
切換える	切換える
切替える	切替える
切立てる	切立てる
切詰める	切詰める
刈り上げる	刈り上げる
刈り入れる	刈り入れる
刈上げる	刈上げる
刈入れる	刈入れる
刎ねる	刎ねる
列ねる	列ねる
初める	初める
判じる	判じる
別ける	別ける
別れる	別れる
利かせる	利かせる
刮げる	刮げる
刳れる	刳れる
刷り上げる	刷り上げる
刷れる	刷れる
刷上げる	刷上げる
刺し止める	刺し止める
刺し違える	刺し違える
刺止める	刺止める
刺違える	刺違える
刻み付ける	刻み付ける
剃り上げる	剃り上げる
剃り下げる	剃り下げる
削げる	削げる
削げ落ちる	削げ落ちる
削れる	削れる
剝がれる	剝がれる
剝ける	剝ける
剝げちょろける	剝げちょろける
剝げる	剝げる
剝げ落ちる	剝げ落ちる
剝れる	剝れる
副える	副える
割ける	割ける
割り付ける	割り付ける
割り切れる	割り切れる
割り合せる	割り合せる
割り当てる	割り当てる
割れる	割れる
割付ける	割付ける
割切れる	割切れる
割当てる	割当てる
剽げる	剽げる
力める	力める
力付ける	力付ける
加える	加える
助ける	助ける
努める	努める
効かせる	効かせる
勇気付ける	勇気付ける
勉める	勉める
動じる	動じる
勘える	勘える
務める	務める
勝ち得る	勝ち得る
勝ち過ぎる	勝ち過ぎる
勝れる	勝れる
勝得る	勝得る
勝過ぎる	勝過ぎる
勢ませる	勢ませる
勤める	勤める
勤め上げる	勤め上げる
勧める	勧める
匂い零れる	匂い零れる
匂わせる	匂わせる
包める	包める
化ける	化ける
千切れる	千切れる
卑しめる	卑しめる
占める	占める
印象付ける	印象付ける
危める	危める
厭きる	厭きる
参じる	参じる
双べる	双べる
収める	収める
取っ捕まえる	取っ捕まえる
取っ掴まえる	取っ掴まえる
取っ替える	取っ替える
取らせる	取らせる
取り上げる	取り上げる
取り上せる	取り上せる
取り下げる	取り下げる
取り並べる	取り並べる
取り乱れる	取り乱れる
取り交ぜる	取り交ぜる
取り付ける	取り付ける
取り入れる	取り入れる
取り分ける	取り分ける
取り収める	取り収める
取り合せる	取り合せる
取り合わせる	取り合わせる
取り固める	取り固める
取り寄せる	取り寄せる
取り広げる	取り広げる
取り憑かれる	取り憑かれる
取り抑える	取り抑える
取り押える	取り押える
取り押さえる	取り押さえる
取り捨てる	取り捨てる
取り揃える	取り揃える
取り換える	取り換える
取り替える	取り替える
取り極める	取り極める
取り止める	取り止める
取り決める	取り決める
取り混ぜる	取り混ぜる
取り添える	取り添える
取り片付ける	取り片付ける
取り率る	取り率る
取り留める	取り留める
取り立てる	取り立てる
取り籠める	取り籠める
取り納める	取り納める
取り紛れる	取り紛れる
取り纏める	取り纏める
取り見る	取り見る
取り詰める	取り詰める
取り調べる	取り調べる
取り逆上る	取り逆上る
取り違える	取り違える
取り鎮める	取り鎮める
取り除ける	取り除ける
取り集める	取り集める
取れる	取れる
取上げる	取上げる
取上せる	取上せる
取下げる	取下げる
取並べる	取並べる
取乱れる	取乱れる
取交ぜる	取交ぜる
取付ける	取付ける
取入れる	取入れる
取分ける	取分ける
取収める	取収める
取合せる	取合せる
取合わせる	取合わせる
取固める	取固める
取寄せる	取寄せる
取広げる	取広げる
取忘れる	取忘れる
取抑える	取抑える
取押える	取押える
取押さえる	取押さえる
取捨てる	取捨てる
取掛ける	取掛ける
取換える	取換える
取替える	取替える
取決める	取決める
取混ぜる	取混ぜる
取添える	取添える
取片付ける	取片付ける
取留める	取留める
取立てる	取立てる
取籠める	取籠める
取納める	取納める
取紛れる	取紛れる
取詰める	取詰める
取調べる	取調べる
取違える	取違える
取鎮める	取鎮める
取集める	取集める
取静める	取静める
受ける	受ける
受け付ける	受け付ける
受け入れる	受け入れる
受け取れる	受け取れる
受け容れる	受け容れる
受け損じる	受け損じる
受け止める	受け止める
受付ける	受付ける
受付る	受付る
受入れる	受入れる
受取れる	受取れる
受容れる	受容れる
受損じる	受損じる
受止める	受止める
叙でる	叙でる
口付ける	口付ける
口慣れる	口慣れる
口説き立てる	口説き立てる
口馴れる	口馴れる
古ける	古ける
古びる	古びる
古呆ける	古呆ける
古惚ける	古惚ける
叩き上げる	叩き上げる
叩き付ける	叩き付ける
叩き伏せる	叩き伏せる
叩き立てる	叩き立てる
叫き立てる	叫き立てる
召される	召される
召し上げる	召し上げる
召し寄せる	召し寄せる
召し抱える	召し抱える
召し替える	召し替える
召し連れる	召し連れる
召上げる	召上げる
召寄せる	召寄せる
召抱える	召抱える
召替える	召替える
召連れる	召連れる
叶える	叶える
合せる	合せる
合わせる	合わせる
吊り上げる	吊り上げる
吊り下げる	吊り下げる
吊るし上げる	吊るし上げる
吊れる	吊れる
同じる	同じる
名乗り出る	名乗り出る
名付ける	名付ける
吐き捨てる	吐き捨てる
吐捨てる	吐捨てる
向い合せる	向い合せる
向い合わせる	向い合わせる
向かい合せる	向かい合せる
向かい合わせる	向かい合わせる
向ける	向ける
向け変える	向け変える
吞み潰れる	吞み潰れる
吟じる	吟じる
吠える	吠える
含める	含める
吸い上げる	吸い上げる
吸い付ける	吸い付ける
吸い入れる	吸い入れる
吸い寄せる	吸い寄せる
吸上げる	吸上げる
吸付ける	吸付ける
吸入れる	吸入れる
吸寄せる	吸寄せる
吹かせる	吹かせる
吹き上げる	吹き上げる
吹き付ける	吹き付ける
吹き入れる	吹き入れる
吹き出る	吹き出る
吹き分ける	吹き分ける
吹き寄せる	吹き寄せる
吹き抜ける	吹き抜ける
吹き掛ける	吹き掛ける
吹き替える	吹き替える
吹き立てる	吹き立てる
吹き荒れる	吹き荒れる
吹き集める	吹き集める
吹き零れる	吹き零れる
吹っ切れる	吹っ切れる
吹っ掛ける	吹っ掛ける
吹上げる	吹上げる
吹付ける	吹付ける
吹入れる	吹入れる
吹出る	吹出る
吹分ける	吹分ける
吹変える	吹変える
吹寄せる	吹寄せる
吹抜ける	吹抜ける
吹掛ける	吹掛ける
吹替える	吹替える
吹着ける	吹着ける
吹立てる	吹立てる
吹荒れる	吹荒れる
吹集める	吹集める
吼える	吼える
呆ける	呆ける
呆れる	呆れる
呆れ果てる	呆れ果てる
呉れる	呉れる
告げる	告げる
告げ知らせる	告げ知らせる
周章てる	周章てる
呼ばれる	呼ばれる
呼び上げる	呼び上げる
呼び付ける	呼び付ける
呼び入れる	呼び入れる
呼び寄せる	呼び寄せる
呼び慣れる	呼び慣れる
呼び掛ける	呼び掛ける
呼び止める	呼び止める
呼び立てる	呼び立てる
呼び続ける	呼び続ける
呼び迎える	呼び迎える
呼び集める	呼び集める
呼び馴れる	呼び馴れる
呼上げる	呼上げる
呼付ける	呼付ける
呼入れる	呼入れる
呼寄せる	呼寄せる
呼慣れる	呼慣れる
呼掛ける	呼掛ける
呼止める	呼止める
呼立てる	呼立てる
呼続ける	呼続ける
呼迎える	呼迎える
呼連れる	呼連れる
呼集める	呼集める
命じる	命じる
和える	和える
和める	和める
和らげる	和らげる
咎める	咎める
咥える	咥える
咬ませる	咬ませる
咲き乱れる	咲き乱れる
咲き初める	咲き初める
咲き溢れる	咲き溢れる
咲き零れる	咲き零れる
咲乱れる	咲乱れる
咲初める	咲初める
咲遅れる	咲遅れる
咳き上げる	咳き上げる
咽せる	咽せる
哺める	哺める
唱える	唱える
問い合せる	問い合せる
問い合わせる	問い合わせる
問い掛ける	問い掛ける
問い詰める	問い詰める
問合せる	問合せる
問合わせる	問合わせる
問掛ける	問掛ける
問詰める	問詰める
啜り上げる	啜り上げる
啣える	啣える
喋り付ける	喋り付ける
喋り立てる	喋り立てる
喚き立てる	喚き立てる
喜ばせる	喜ばせる
喩える	喩える
嗄びる	嗄びる
嗄れる	嗄れる
嗅ぎ付ける	嗅ぎ付ける
嗅ぎ分ける	嗅ぎ分ける
嗅ぎ当てる	嗅ぎ当てる
嗾ける	嗾ける
嘆じる	嘆じる
嘗める	嘗める
嘶える	嘶える
噎せる	噎せる
噛ませる	噛ませる
噛み分ける	噛み分ける
噛み合せる	噛み合せる
噛み合わせる	噛み合わせる
噛み締める	噛み締める
噦り上げる	噦り上げる
噴き上げる	噴き上げる
噴き出る	噴き出る
噴上げる	噴上げる
噴出る	噴出る
嚇し付ける	嚇し付ける
嚔ひる	嚔ひる
嚔る	嚔る
嚙ませる	嚙ませる
嚙み交ぜる	嚙み交ぜる
嚙み分ける	嚙み分ける
嚙み合せる	嚙み合せる
嚙み締める	嚙み締める
嚬める	嚬める
嚼ませる	嚼ませる
囃し立てる	囃し立てる
囚われる	囚われる
回し入れる	回し入れる
回し掛ける	回し掛ける
回り合せる	回り合せる
回る	回る
団居る	団居る
困じる	困じる
困じ果てる	困じ果てる
困り果てる	困り果てる
図抜ける	図抜ける
固める	固める
圧し曲げる	圧し曲げる
在り合せる	在り合せる
在り合わせる	在り合わせる
垂れる	垂れる
垂れ籠める	垂れ籠める
垂れ込める	垂れ込める
垢抜ける	垢抜ける
垢染みる	垢染みる
垣間見る	垣間見る
埋ける	埋ける
埋める	埋める
埋め合せる	埋め合せる
埋め合わせる	埋め合わせる
埋め立てる	埋め立てる
埋もれる	埋もれる
執り見る	執り見る
基礎付ける	基礎付ける
堕ちる	堕ちる
堪える	堪える
堪え兼ねる	堪え兼ねる
堪り兼ねる	堪り兼ねる
堪兼ねる	堪兼ねる
堰き上げる	堰き上げる
堰き止める	堰き止める
報いる	報いる
報える	報える
報じる	報じる
報せる	報せる
場慣れる	場慣れる
場馴れる	場馴れる
塗り上げる	塗り上げる
塗り付ける	塗り付ける
塗り固める	塗り固める
塗り替える	塗り替える
塗り立てる	塗り立てる
塗り籠める	塗り籠める
塗り込める	塗り込める
塗れる	塗れる
塗上げる	塗上げる
塗付ける	塗付ける
塗固める	塗固める
塗替える	塗替える
塗立てる	塗立てる
塗籠める	塗籠める
塗込める	塗込める
塞き上げる	塞き上げる
塞き敢う	塞き敢う
塞き止める	塞き止める
塞げる	塞げる
塡める	塡める
塩垂れる	塩垂れる
増える	増える
墜ちる	墜ちる
壊える	壊える
壊れる	壊れる
売り上げる	売り上げる
売り下げる	売り下げる
売り付ける	売り付ける
売り切れる	売り切れる
売り抜ける	売り抜ける
売れる	売れる
売上げる	売上げる
売下げる	売下げる
売付ける	売付ける
売切れる	売切れる
売抜ける	売抜ける
変える	変える
変じる	変じる
変り果てる	変り果てる
変わり果てる	変わり果てる
変化る	変化る
変換える	変換える
夕栄える	夕栄える
外れる	外れる
夢見る	夢見る
大人じみる	大人じみる
大人びる	大人びる
大人染みる	大人染みる
失せる	失せる
奉じる	奉じる
奏でる	奏でる
奨める	奨める
妨げる	妨げる
妻せる	妻せる
妻合せる	妻合せる
妻合わせる	妻合わせる
始める	始める
委せる	委せる
委ねる	委ねる
婆娑れる	婆娑れる
媚びる	媚びる
子供染みる	子供染みる
存える	存える
存じる	存じる
存じ上げる	存じ上げる
守り立てる	守り立てる
守り育てる	守り育てる
守立てる	守立てる
安らげる	安らげる
安んじる	安んじる
定める	定める
宛てる	宛てる
宣べる	宣べる
宥める	宥める
容れる	容れる
寂びる	寂びる
寂れる	寂れる
寄える	寄える
寄せる	寄せる
寄せ付ける	寄せ付ける
寄せ合せる	寄せ合せる
寄せ合わせる	寄せ合わせる
寄せ掛ける	寄せ掛ける
寄せ集める	寄せ集める
寄り居る	寄り居る
寄付ける	寄付ける
寄合せる	寄合せる
寄合わる	寄合わる
寄掛ける	寄掛ける
寄集める	寄集める
寐る	寐る
寛げる	寛げる
寝かし付ける	寝かし付ける
寝かせる	寝かせる
寝せる	寝せる
寝せ付ける	寝せ付ける
寝そびれる	寝そびれる
寝はぐれる	寝はぐれる
寝る	寝る
寝れる	寝れる
寝乱れる	寝乱れる
寝倒れる	寝倒れる
寝忘れる	寝忘れる
寝惚ける	寝惚ける
寝惚れる	寝惚れる
寝腐れる	寝腐れる
寝腫れる	寝腫れる
寝覚める	寝覚める
寝過ぎる	寝過ぎる
寝違える	寝違える
寝飽きる	寝飽きる
察しる	察しる
封じる	封じる
封じ込める	封じ込める
射り付ける	射り付ける
射る	射る
射中てる	射中てる
射付ける	射付ける
射当てる	射当てる
射掛ける	射掛ける
射止める	射止める
射立てる	射立てる
射竦める	射竦める
将る	将る
尋ねる	尋ねる
尋ね合せる	尋ね合せる
尋ね合わせる	尋ね合わせる
尋ね当てる	尋ね当てる
小ませる	小ませる
小止れる	小止れる
小洒落る	小洒落る
小隠れる	小隠れる
就ける	就ける
尽きる	尽きる
尽き果てる	尽き果てる
尽れる	尽れる
尽果てる	尽果てる
居る	居る
居合せる	居合せる
居合わせる	居合わせる
居流れる	居流れる
居浸れる	居浸れる
屈める	屈める
届ける	届ける
届け出る	届け出る
届出る	届出る
展べ観る	展べ観る
屡見る	屡見る
屢見る	屢見る
履き捨てる	履き捨てる
履き替える	履き替える
履き違える	履き違える
履捨てる	履捨てる
履替える	履替える
履違える	履違える
岡惚れる	岡惚れる
崇める	崇める
崩える	崩える
崩じる	崩じる
崩れる	崩れる
崩れ落ちる	崩れ落ちる
嵌める	嵌める
嵩じる	嵩じる
巡り会せる	巡り会せる
巡り会わせる	巡り会わせる
巡り合せる	巡り合せる
巡り合わせる	巡り合わせる
差し上げる	差し上げる
差し付ける	差し付ける
差し伸べる	差し伸べる
差し入れる	差し入れる
差し出る	差し出る
差し加える	差し加える
差し向ける	差し向ける
差し固める	差し固める
差し延べる	差し延べる
差し当てる	差し当てる
差し押える	差し押える
差し押さえる	差し押さえる
差し掛ける	差し掛ける
差し控える	差し控える
差し換える	差し換える
差し支える	差し支える
差し替える	差し替える
差し止める	差し止める
差し添える	差し添える
差し立てる	差し立てる
差し縺れる	差し縺れる
差し越える	差し越える
差し違える	差し違える
差上げる	差上げる
差付ける	差付ける
差伸べる	差伸べる
差入れる	差入れる
差出る	差出る
差加える	差加える
差向ける	差向ける
差固める	差固める
差延べる	差延べる
差当てる	差当てる
差押える	差押える
差押さえる	差押さえる
差掛ける	差掛ける
差控える	差控える
差換える	差換える
差支える	差支える
差替える	差替える
差止める	差止める
差添える	差添える
差立てる	差立てる
差越える	差越える
差違える	差違える
己惚れる	己惚れる
已める	已める
巻き上げる	巻き上げる
巻き付ける	巻き付ける
巻き揚げる	巻き揚げる
巻上げる	巻上げる
巻付ける	巻付ける
巻揚げる	巻揚げる
巻替える	巻替える
帯びる	帯びる
干し上げる	干し上げる
干し固める	干し固める
干る	干る
干上げる	干上げる
干割れる	干割れる
干固める	干固める
干涸びる	干涸びる
平める	平める
平らげる	平らげる
年寄り染みる	年寄り染みる
年寄染みる	年寄染みる
年老いる	年老いる
年長ける	年長ける
幼びる	幼びる
広げる	広げる
広める	広める
序でる	序でる
度外れる	度外れる
廃れる	廃れる
延びる	延びる
延べる	延べる
建てる	建てる
建て付ける	建て付ける
建て替える	建て替える
建並べる	建並べる
建付ける	建付ける
建替える	建替える
廻る	廻る
弁える	弁える
弁じる	弁じる
弁じ付ける	弁じ付ける
弁じ立てる	弁じ立てる
弊える	弊える
引かされる	引かされる
引き上げる	引き上げる
引き下げる	引き下げる
引き付ける	引き付ける
引き入れる	引き入れる
引き分ける	引き分ける
引き受ける	引き受ける
引き合せる	引き合せる
引き合わせる	引き合わせる
引き寄せる	引き寄せる
引き当てる	引き当てる
引き括める	引き括める
引き据える	引き据える
引き掛ける	引き掛ける
引き揃える	引き揃える
引き揚げる	引き揚げる
引き換える	引き換える
引き攣れる	引き攣れる
引き替える	引き替える
引き止める	引き止める
引き比べる	引き比べる
引き留める	引き留める
引き立てる	引き立てる
引き締める	引き締める
引き詰める	引き詰める
引き較べる	引き較べる
引き込める	引き込める
引き退ける	引き退ける
引き連れる	引き連れる
引き違える	引き違える
引ける	引ける
引っ下げる	引っ下げる
引っ付ける	引っ付ける
引っ張り上げる	引っ張り上げる
引っ懸ける	引っ懸ける
引っ抱える	引っ抱える
引っ括める	引っ括める
引っ捕える	引っ捕える
引っ捕まえる	引っ捕まえる
引っ捕らえる	引っ捕らえる
引っ掛ける	引っ掛ける
引っ掴まえる	引っ掴まえる
引っ提げる	引っ提げる
引っ立てる	引っ立てる
引っ紮げる	引っ紮げる
引っ絡げる	引っ絡げる
引っ詰める	引っ詰める
引っ込める	引っ込める
引上げる	引上げる
引下げる	引下げる
引付ける	引付ける
引入れる	引入れる
引分ける	引分ける
引受ける	引受ける
引合せる	引合せる
引合わせる	引合わせる
引寄せる	引寄せる
引当てる	引当てる
引据える	引据える
引掛ける	引掛ける
引揚げる	引揚げる
引換える	引換える
引替える	引替える
引止める	引止める
引比べる	引比べる
引留める	引留める
引立てる	引立てる
引締める	引締める
引詰める	引詰める
引込める	引込める
引連れる	引連れる
引違える	引違える
引開ける	引開ける
弘める	弘める
弛める	弛める
弱める	弱める
弱り果てる	弱り果てる
張り上げる	張り上げる
張り付ける	張り付ける
張り切れる	張り切れる
張り合せる	張り合せる
張り合わせる	張り合わせる
張り替える	張り替える
張り裂ける	張り裂ける
張り詰める	張り詰める
張上げる	張上げる
張付ける	張付ける
張切れる	張切れる
張替える	張替える
張裂ける	張裂ける
張詰める	張詰める
強いる	強いる
強い付ける	強い付ける
強める	強める
強請り掛ける	強請り掛ける
強請れる	強請れる
弾ける	弾ける
弾じる	弾じる
弾ませる	弾ませる
当てる	当てる
当て付ける	当て付ける
当て嵌める	当て嵌める
彫り上げる	彫り上げる
彫り付ける	彫り付ける
彫上げる	彫上げる
彫付ける	彫付ける
役立てる	役立てる
待たせる	待たせる
待ち付ける	待ち付ける
待ち伏せる	待ち伏せる
待ち侘びる	待ち侘びる
待ち倦ねる	待ち倦ねる
待ち兼ねる	待ち兼ねる
待ち受ける	待ち受ける
待ち合せる	待ち合せる
待ち合わせる	待ち合わせる
待ち構える	待ち構える
待ち焦がれる	待ち焦がれる
待ち草臥れる	待ち草臥れる
待ち設ける	待ち設ける
待付ける	待付ける
待伏せる	待伏せる
待兼ねる	待兼ねる
待受ける	待受ける
待合せる	待合せる
待合わせる	待合わせる
待構える	待構える
待焦がれる	待焦がれる
待設ける	待設ける
後らせる	後らせる
後れる	後れる
後ろ見る	後ろ見る
従える	従える
得る	得る
御不洒落る	御不洒落る
御出でなされる	御出でなされる
御出でる	御出でる
御覧じる	御覧じる
復習える	復習える
微温める	微温める
心付ける	心付ける
心得る	心得る
心懸ける	心懸ける
心掛ける	心掛ける
忍ばせる	忍ばせる
忘れる	忘れる
応える	応える
応じる	応じる
念じる	念じる
念掛ける	念掛ける
怒らせる	怒らせる
怒鳴り付ける	怒鳴り付ける
怒鳴り立てる	怒鳴り立てる
怖ける	怖ける
怖じる	怖じる
怖じ恐れる	怖じ恐れる
怖める	怖める
怖れる	怖れる
思い乱れる	思い乱れる
思い倦ねる	思い倦ねる
思い僻める	思い僻める
思い合せる	思い合せる
思い合わせる	思い合わせる
思い定める	思い定める
思い染める	思い染める
思い比べる	思い比べる
思い浮かべる	思い浮かべる
思い浮べる	思い浮べる
思い焦がれる	思い焦がれる
思い知らせる	思い知らせる
思い続ける	思い続ける
思い見る	思い見る
思い設ける	思い設ける
思い詰める	思い詰める
思い違える	思い違える
思い頽れる	思い頽れる
思える	思える
怠ける	怠ける
急かせる	急かせる
急がせる	急がせる
急き上げる	急き上げる
急き立てる	急き立てる
怨じる	怨じる
怯える	怯える
怺える	怺える
恋いる	恋いる
恋い初める	恋い初める
恋い焦がれる	恋い焦がれる
恋初める	恋初める
恋焦がれる	恋焦がれる
恍ける	恍ける
恍れる	恍れる
恐れる	恐れる
恥しめる	恥しめる
恥じる	恥じる
恨みる	恨みる
息絶える	息絶える
恵まれる	恵まれる
悄気る	悄気る
悔いる	悔いる
悔い改める	悔い改める
悔改める	悔改める
患える	患える
悦ばせる	悦ばせる
悩める	悩める
悪たれる	悪たれる
悪怯れる	悪怯れる
悪怯れるふうじこめる	悪怯れるふうじこめる
悴ける	悴ける
悴せる	悴せる
悶える	悶える
惘れる	惘れる
惚ける	惚ける
惚れる	惚れる
惚気る	惚気る
惟る	惟る
愁える	愁える
意味付ける	意味付ける
愛でる	愛でる
感ける	感ける
感じる	感じる
愧じる	愧じる
愬える	愬える
慊りる	慊りる
慌てる	慌てる
慙じる	慙じる
慢じる	慢じる
慣れる	慣れる
慥かめる	慥かめる
慰める	慰める
憂える	憂える
憑かれる	憑かれる
憤ける	憤ける
憧れる	憧れる
憬れる	憬れる
懐ける	懐ける
懲らしめる	懲らしめる
懲りる	懲りる
懶ける	懶ける
懸ける	懸ける
懸け隔てる	懸け隔てる
懸け離れる	懸け離れる
懸隔てる	懸隔てる
懸離れる	懸離れる
懼れる	懼れる
成し遂げる	成し遂げる
成り果せる	成り果せる
成り果てる	成り果てる
成果てる	成果てる
成遂げる	成遂げる
戒める	戒める
戯える	戯える
戯ける	戯ける
戯らける	戯らける
戯れる	戯れる
戴ける	戴ける
所帯染みる	所帯染みる
扇ぎ立てる	扇ぎ立てる
手まへる	手まへる
手向ける	手向ける
手慣れる	手慣れる
手懐ける	手懐ける
手懸ける	手懸ける
手掛ける	手掛ける
手控える	手控える
手摩れる	手摩れる
手擦れる	手擦れる
手支へる	手支へる
手繰り上げる	手繰り上げる
手繰り寄せる	手繰り寄せる
手繰上げる	手繰上げる
手繰寄せる	手繰寄せる
手馴れる	手馴れる
才弾ける	才弾ける
打ちまける	打ちまける
打ち上げる	打ち上げる
打ち付ける	打ち付ける
打ち切れる	打ち切れる
打ち合せる	打ち合せる
打ち合わせる	打ち合わせる
打ち始める	打ち始める
打ち寄せる	打ち寄せる
打ち廻る	打ち廻る
打ち当てる	打ち当てる
打ち忘れる	打ち忘れる
打ち懸ける	打ち懸ける
打ち捨てる	打ち捨てる
打ち据える	打ち据える
打ち掛ける	打ち掛ける
打ち揚げる	打ち揚げる
打ち損じる	打ち損じる
打ち明ける	打ち明ける
打ち替える	打ち替える
打ち止める	打ち止める
打ち留める	打ち留める
打ち眺める	打ち眺める
打ち立てる	打ち立てる
打ち絶える	打ち絶える
打ち萎れる	打ち萎れる
打ち見る	打ち見る
打ち解ける	打ち解ける
打ち詫びる	打ち詫びる
打ち連れる	打ち連れる
打ち過ぎる	打ち過ぎる
打ち違える	打ち違える
打ち開ける	打ち開ける
打ち震える	打ち震える
打ち顰める	打ち顰める
打って出る	打って出る
打っ付ける	打っ付ける
打っ倒れる	打っ倒れる
打っ切れる	打っ切れる
打っ掛ける	打っ掛ける
打っ締める	打っ締める
打っ魂消る	打っ魂消る
打つける	打つける
打ん剝れる	打ん剝れる
打ん投げる	打ん投げる
打上げる	打上げる
打付ける	打付ける
打合せる	打合せる
打合わせる	打合わせる
打始める	打始める
打寄せる	打寄せる
打当てる	打当てる
打忘れる	打忘れる
打懸ける	打懸ける
打捨てる	打捨てる
打据える	打据える
打掛ける	打掛ける
打揚げる	打揚げる
打明ける	打明ける
打止める	打止める
打留める	打留める
打眺める	打眺める
打立てる	打立てる
打紛れる	打紛れる
打絶える	打絶える
打続ける	打続ける
打見る	打見る
打解ける	打解ける
打連れる	打連れる
打過ぎる	打過ぎる
打違える	打違える
打震える	打震える
払い上げる	払い上げる
払い下げる	払い下げる
払い除ける	払い除ける
払下げる	払下げる
扣える	扣える
扱き混ぜる	扱き混ぜる
扶ける	扶ける
承ける	承ける
抉じる	抉じる
抉じ入れる	抉じ入れる
抉じ開ける	抉じ開ける
抉れる	抉れる
抑える	抑える
抑え付ける	抑え付ける
投げる	投げる
投げ付ける	投げ付ける
投げ入れる	投げ入れる
投げ捨てる	投げ捨てる
投げ掛ける	投げ掛ける
投げ棄てる	投げ棄てる
投じる	投じる
投付ける	投付ける
投入れる	投入れる
投捨てる	投捨てる
投掛ける	投掛ける
折り曲げる	折り曲げる
折り重ねる	折り重ねる
折れる	折れる
折曲げる	折曲げる
折重ねる	折重ねる
抜きん出る	抜きん出る
抜き出る	抜き出る
抜き合せる	抜き合せる
抜き合わせる	抜き合わせる
抜き連れる	抜き連れる
抜ける	抜ける
抜け出る	抜け出る
抜け落ちる	抜け落ちる
抜出る	抜出る
抜合せる	抜合せる
抜合わせる	抜合わせる
抜連れる	抜連れる
抱える	抱える
抱き上げる	抱き上げる
抱き合せる	抱き合せる
抱き合わせる	抱き合わせる
抱き寄せる	抱き寄せる
抱き抱える	抱き抱える
抱き留める	抱き留める
抱き竦める	抱き竦める
抱き締める	抱き締める
抱上げる	抱上げる
抱入れる	抱入れる
抱合せる	抱合せる
抱合わせる	抱合わせる
抱寄せる	抱寄せる
抱留める	抱留める
抱締める	抱締める
押える	押える
押え付ける	押え付ける
押さえる	押さえる
押さえ付ける	押さえ付ける
押し上げる	押し上げる
押し下げる	押し下げる
押し並べる	押し並べる
押し付ける	押し付ける
押し伏せる	押し伏せる
押し入れる	押し入れる
押し分ける	押し分ける
押し向ける	押し向ける
押し寄せる	押し寄せる
押し広げる	押し広げる
押し広める	押し広める
押し当てる	押し当てる
押し掛ける	押し掛ける
押し曲げる	押し曲げる
押し止める	押し止める
押し沈める	押し沈める
押し立てる	押し立てる
押し詰める	押し詰める
押し込める	押し込める
押し退ける	押し退ける
押し進める	押し進める
押し鎮める	押し鎮める
押し開ける	押し開ける
押っ付ける	押っ付ける
押っ伏せる	押っ伏せる
押っ始める	押っ始める
押っ広げる	押っ広げる
押っ立てる	押っ立てる
押っ被せる	押っ被せる
押っ魂消る	押っ魂消る
押上げる	押上げる
押下げる	押下げる
押並べる	押並べる
押付ける	押付ける
押伏せる	押伏せる
押入れる	押入れる
押分ける	押分ける
押向ける	押向ける
押寄せる	押寄せる
押広げる	押広げる
押広める	押広める
押延べる	押延べる
押当てる	押当てる
押掛ける	押掛ける
押曲げる	押曲げる
押止める	押止める
押沈める	押沈める
押立てる	押立てる
押詰める	押詰める
押込める	押込める
押進める	押進める
押鎮める	押鎮める
押開ける	押開ける
抽んでる	抽んでる
担ぎ上げる	担ぎ上げる
担げる	担げる
拈くれる	拈くれる
拉げる	拉げる
拗くれる	拗くれる
拗ける	拗ける
拗じくれる	拗じくれる
拗じる	拗じる
拗ねる	拗ねる
拗らせる	拗らせる
拗れる	拗れる
招き入れる	招き入れる
招き寄せる	招き寄せる
招じる	招じる
招じ入れる	招じ入れる
拡げる	拡げる
括し上げる	括し上げる
括し付ける	括し付ける
括り上げる	括り上げる
括り付ける	括り付ける
括れる	括れる
拭き立てる	拭き立てる
拵える	拵える
拾い上げる	拾い上げる
持たせる	持たせる
持たせ掛ける	持たせ掛ける
持ちゃげる	持ちゃげる
持ち上げる	持ち上げる
持ち付ける	持ち付ける
持ち合せる	持ち合せる
持ち合わせる	持ち合わせる
持ち堪える	持ち堪える
持ち掛ける	持ち掛ける
持ち替える	持ち替える
持てる	持てる
持上げる	持上げる
持付ける	持付ける
持合せる	持合せる
持合わせる	持合わせる
持掛ける	持掛ける
持替える	持替える
持添える	持添える
指し掛ける	指し掛ける
指折り数える	指折り数える
指掛ける	指掛ける
按じる	按じる
挙げる	挙げる
挟み入れる	挟み入れる
挫ける	挫ける
振られる	振られる
振り上げる	振り上げる
振り付ける	振り付ける
振り分ける	振り分ける
振り切れる	振り切れる
振り向ける	振り向ける
振り当てる	振り当てる
振り懸ける	振り懸ける
振り捨てる	振り捨てる
振り掛ける	振り掛ける
振り放け見る	振り放け見る
振り替える	振り替える
振り立てる	振り立てる
振れる	振れる
振上げる	振上げる
振付ける	振付ける
振分ける	振分ける
振向ける	振向ける
振当てる	振当てる
振捨てる	振捨てる
振掛ける	振掛ける
振替える	振替える
振立てる	振立てる
挿げる	挿げる
挿げ替える	挿げ替える
捉える	捉える
捉まえる	捉まえる
捉われる	捉われる
捌ける	捌ける
捏ちる	捏ちる
捏ち上げる	捏ち上げる
捏ねる	捏ねる
捏ね上げる	捏ね上げる
捏ね合せる	捏ね合せる
捏ね合わせる	捏ね合わせる
捕える	捕える
捕まえる	捕まえる
捕らえる	捕らえる
捕らわれる	捕らわれる
捕れる	捕れる
捕われる	捕われる
捜し倦ねる	捜し倦ねる
捜し当てる	捜し当てる
捜し求める	捜し求める
捥げる	捥げる
捥れる	捥れる
捧げる	捧げる
捨てる	捨てる
捩くれる	捩くれる
捩じくれる	捩じくれる
捩じり上げる	捩じり上げる
捩じる	捩じる
捩じ上げる	捩じ上げる
捩じ付ける	捩じ付ける
捩じ伏せる	捩じ伏せる
捩じ向ける	捩じ向ける
捩じ曲げる	捩じ曲げる
捩じ開ける	捩じ開ける
捩れる	捩れる
据える	据える
据え付ける	据え付ける
据付ける	据付ける
捲き上げる	捲き上げる
捲し上げる	捲し上げる
捲し掛ける	捲し掛ける
捲し立てる	捲し立てる
捲り上げる	捲り上げる
捲れる	捲れる
捻くれる	捻くれる
捻じくれる	捻じくれる
捻じる	捻じる
捻じ上げる	捻じ上げる
捻じ付ける	捻じ付ける
捻じ伏せる	捻じ伏せる
捻じ向ける	捻じ向ける
捻じ曲げる	捻じ曲げる
捻じ開ける	捻じ開ける
捻れる	捻れる
掃き捨てる	掃き捨てる
掃き清める	掃き清める
掃寄せる	掃寄せる
掃捨てる	掃捨てる
掃清める	掃清める
授ける	授ける
掏り替える	掏り替える
掘り下げる	掘り下げる
掘り当てる	掘り当てる
掘れる	掘れる
掘下げる	掘下げる
掘当てる	掘当てる
掘立てる	掘立てる
掛ける	掛ける
掛け合せる	掛け合せる
掛け合わせる	掛け合わせる
掛け替える	掛け替える
掛け連ねる	掛け連ねる
掛け離れる	掛け離れる
掛合せる	掛合せる
掛合わせる	掛合わせる
掛替える	掛替える
掛離れる	掛離れる
掠める	掠める
掠れる	掠れる
採れる	採れる
探し当てる	探し当てる
探し求める	探し求める
探り当てる	探り当てる
接ぎ合せる	接ぎ合せる
接ぎ合わせる	接ぎ合わせる
接しる	接しる
控える	控える
推し当てる	推し当てる
推し進める	推し進める
推当てる	推当てる
推進める	推進める
掬い上げる	掬い上げる
掲げる	掲げる
掴まえる	掴まえる
掴ませる	掴ませる
掻き上げる	掻き上げる
掻き乱れる	掻き乱れる
掻き分ける	掻き分ける
掻き合せる	掻き合せる
掻き合わせる	掻き合わせる
掻き寄せる	掻き寄せる
掻き揚げる	掻き揚げる
掻き撫でる	掻き撫でる
掻き暗れる	掻き暗れる
掻き暮れる	掻き暮れる
掻き消える	掻き消える
掻き混ぜる	掻き混ぜる
掻き立てる	掻き立てる
掻き退ける	掻き退ける
掻き集める	掻き集める
掻き雑ぜる	掻き雑ぜる
掽へる	掽へる
揃える	揃える
揉み立てる	揉み立てる
揉める	揉める
提げる	提げる
揚げる	揚げる
換える	換える
握らせる	握らせる
握り締める	握り締める
握り詰める	握り詰める
援ける	援ける
揺さぶれる	揺さぶれる
揺さ振れる	揺さ振れる
揺すぶれる	揺すぶれる
揺すり上げる	揺すり上げる
揺すれる	揺すれる
揺す振れる	揺す振れる
揺られる	揺られる
揺り上げる	揺り上げる
揺り分ける	揺り分ける
揺れる	揺れる
損じる	損じる
損ねる	損ねる
搔き上げる	搔き上げる
搔き乗せる	搔き乗せる
搔き乱れる	搔き乱れる
搔き入れる	搔き入れる
搔き分ける	搔き分ける
搔き合せる	搔き合せる
搔き寄せる	搔き寄せる
搔き揚げる	搔き揚げる
搔き撫でる	搔き撫でる
搔き暗れる	搔き暗れる
搔き暮れる	搔き暮れる
搔き消える	搔き消える
搔き混ぜる	搔き混ぜる
搔き立てる	搔き立てる
搔き退ける	搔き退ける
搔き集める	搔き集める
搔き雑ぜる	搔き雑ぜる
搗き交ぜる	搗き交ぜる
搗ち上げる	搗ち上げる
搦める	搦める
携える	携える
搾り上げる	搾り上げる
摑まえる	摑まえる
摑ませる	摑ませる
摑まへる	摑まへる
摧ける	摧ける
摩り付ける	摩り付ける
摩り切れる	摩り切れる
摩れる	摩れる
摺り付ける	摺り付ける
摺り切れる	摺り切れる
摺り合せる	摺り合せる
摺り合わせる	摺り合わせる
撓える	撓える
撓める	撓める
撓垂れる	撓垂れる
撚り合せる	撚り合せる
撚り合わせる	撚り合わせる
撚れる	撚れる
撥ねる	撥ねる
撥ね上げる	撥ね上げる
撥ね付ける	撥ね付ける
撥ね掛ける	撥ね掛ける
撥ね除ける	撥ね除ける
撫ぜる	撫ぜる
撫でる	撫でる
撫で上げる	撫で上げる
撫で付ける	撫で付ける
撮れる	撮れる
擂れる	擂れる
擡げる	擡げる
擢んでる	擢んでる
擦り上げる	擦り上げる
擦り付ける	擦り付ける
擦り切れる	擦り切れる
擦り剝ける	擦り剝ける
擦り合せる	擦り合せる
擦り抜ける	擦り抜ける
擦れる	擦れる
擦付ける	擦付ける
擦切れる	擦切れる
擦抜ける	擦抜ける
擬える	擬える
攀じる	攀じる
攣れる	攣れる
攪てる	攪てる
支える	支える
攲てる	攲てる
改める	改める
攻める	攻める
攻め付ける	攻め付ける
攻め寄せる	攻め寄せる
攻め掛ける	攻め掛ける
攻め立てる	攻め立てる
攻付ける	攻付ける
攻寄せる	攻寄せる
攻懸ける	攻懸ける
攻掛ける	攻掛ける
攻立てる	攻立てる
放り上げる	放り上げる
放り投げる	放り投げる
放れる	放れる
救い上げる	救い上げる
敗れる	敗れる
教える	教える
散ける	散ける
散じる	散じる
散りばめる	散りばめる
散り乱れる	散り乱れる
散乱れる	散乱れる
散初める	散初める
数える	数える
数え上げる	数え上げる
数え立てる	数え立てる
整える	整える
敷き詰める	敷き詰める
敷詰める	敷詰める
斉える	斉える
斥ける	斥ける
斬り付ける	斬り付ける
斬り伏せる	斬り伏せる
斬り捨てる	斬り捨てる
斬り掛ける	斬り掛ける
斬付ける	斬付ける
斬伏せる	斬伏せる
斬捨てる	斬捨てる
斬掛ける	斬掛ける
断じる	断じる
方向付ける	方向付ける
旅慣れる	旅慣れる
旅馴れる	旅馴れる
旧びる	旧びる
早める	早める
昂じる	昂じる
明ける	明ける
明け初める	明け初める
明け広げる	明け広げる
明け放れる	明け放れる
明け暮れる	明け暮れる
明け離れる	明け離れる
明らめる	明らめる
昏れる	昏れる
映える	映える
映じる	映じる
時化る	時化る
時雨れる	時雨れる
晩じる	晩じる
晴れる	晴れる
暈ける	暈ける
暖める	暖める
暗れる	暗れる
暮れる	暮れる
暮れ果てる	暮れ果てる
暮れ落ちる	暮れ落ちる
暴き立てる	暴き立てる
暴れる	暴れる
曇らせる	曇らせる
曝ける	曝ける
曝れる	曝れる
曲げる	曲げる
更ける	更ける
書き上げる	書き上げる
書き並べる	書き並べる
書き付ける	書き付ける
書き伝える	書き伝える
書き入れる	書き入れる
書き分ける	書き分ける
書き加える	書き加える
書き慣れる	書き慣れる
書き捨てる	書き捨てる
書き換える	書き換える
書き損じる	書き損じる
書き改める	書き改める
書き替える	書き替える
書き果せる	書き果せる
書き添える	書き添える
書き溜める	書き溜める
書き留める	書き留める
書き立てる	書き立てる
書き納める	書き納める
書き続ける	書き続ける
書き認める	書き認める
書き連ねる	書き連ねる
書き集める	書き集める
書き馴れる	書き馴れる
書上げる	書上げる
書並べる	書並べる
書付ける	書付ける
書伝える	書伝える
書入れる	書入れる
書分ける	書分ける
書加える	書加える
書忘れる	書忘れる
書慣れる	書慣れる
書捨てる	書捨てる
書換える	書換える
書損じる	書損じる
書改める	書改める
書替える	書替える
書添える	書添える
書留める	書留める
書立てる	書立てる
書納める	書納める
書続ける	書続ける
書連ねる	書連ねる
書間違える	書間違える
書集める	書集める
替える	替える
月並みる	月並みる
有り合せる	有り合せる
有り合わせる	有り合わせる
有り得る	有り得る
有り触れる	有り触れる
望み見る	望み見る
末枯れる	末枯れる
朽ちる	朽ちる
朽ち果てる	朽ち果てる
朽果てる	朽果てる
杓れる	杓れる
束ねる	束ねる
来れる	来れる
来合せる	来合せる
来合わせる	来合わせる
来慣れる	来慣れる
来馴れる	来馴れる
枉げる	枉げる
果せる	果せる
果てる	果てる
枝垂れる	枝垂れる
枯らびる	枯らびる
枯れる	枯れる
枯れ果てる	枯れ果てる
枯れ落ちる	枯れ落ちる
染みる	染みる
染み出る	染み出る
染める	染める
染め上げる	染め上げる
染め付ける	染め付ける
染め分ける	染め分ける
染め変える	染め変える
染め替える	染め替える
染上げる	染上げる
染付ける	染付ける
染出る	染出る
染分ける	染分ける
染変える	染変える
染替える	染替える
栄える	栄える
案じる	案じる
棄てる	棄てる
棲み分ける	棲み分ける
植える	植える
植え付ける	植え付ける
植え換える	植え換える
植え替える	植え替える
植付ける	植付ける
植換える	植換える
植換る	植換る
植替える	植替える
植替る	植替る
業染みる	業染みる
極める	極める
極め付ける	極め付ける
楽しませる	楽しませる
構い付ける	構い付ける
構える	構える
横たえる	横たえる
欠ける	欠ける
歌い上げる	歌い上げる
歎じる	歎じる
止める	止める
歪める	歪める
歴る	歴る
死に切れる	死に切れる
死に別れる	死に別れる
死に後れる	死に後れる
死に懸ける	死に懸ける
死に掛ける	死に掛ける
死に果てる	死に果てる
死に絶える	死に絶える
死に遅れる	死に遅れる
殉じる	殉じる
殖える	殖える
殴り付ける	殴り付ける
殺げる	殺げる
殺める	殺める
毀れる	毀れる
比える	比える
比べる	比べる
比べ合せる	比べ合せる
比べ合わせる	比べ合わせる
気圧される	気圧される
気押される	気押される
気構える	気構える
気触れる	気触れる
気違い染みる	気違い染みる
永らえる	永らえる
求める	求める
汗染みる	汗染みる
汚れる	汚れる
汲み上げる	汲み上げる
汲み入れる	汲み入れる
汲み分ける	汲み分ける
決める	決める
決め付ける	決め付ける
決れる	決れる
決定付ける	決定付ける
沁みる	沁みる
沃る	沃る
沈める	沈める
沸かせる	沸かせる
油染みる	油染みる
治める	治める
泊める	泊める
泛かべる	泛かべる
泡立てる	泡立てる
泣かせる	泣かせる
泣き別れる	泣き別れる
泣き崩れる	泣き崩れる
泣き濡れる	泣き濡れる
泣き立てる	泣き立てる
泣ける	泣ける
泣別れる	泣別れる
泣崩れる	泣崩れる
泣立てる	泣立てる
泳がせる	泳がせる
洒落る	洒落る
洗い上げる	洗い上げる
洗い立てる	洗い立てる
洩れる	洩れる
活ける	活ける
流れる	流れる
流れ出る	流れ出る
流れ落ちる	流れ落ちる
流行らせる	流行らせる
浄める	浄める
浅せる	浅せる
浚える	浚える
浮かされる	浮かされる
浮かせる	浮かせる
浮かばれる	浮かばれる
浮かび出る	浮かび出る
浮かべる	浮かべる
浮かれる	浮かれる
浮かれ出る	浮かれ出る
浮き出る	浮き出る
浮ばれる	浮ばれる
浮び出る	浮び出る
浮べる	浮べる
浮れる	浮れる
浮れ出る	浮れ出る
浮出る	浮出る
浴びせる	浴びせる
浴びせ掛ける	浴びせ掛ける
浴びる	浴びる
浸ける	浸ける
浸みる	浸みる
消える	消える
消え失せる	消え失せる
消え果てる	消え果てる
消し止める	消し止める
涌き出る	涌き出る
涸びる	涸びる
涸れる	涸れる
淀める	淀める
淘げる	淘げる
淘り分ける	淘り分ける
深ける	深ける
深める	深める
混じる	混じる
混ぜる	混ぜる
混ぜ合せる	混ぜ合せる
混ぜ合わせる	混ぜ合わせる
添い遂げる	添い遂げる
添える	添える
添わせる	添わせる
添遂げる	添遂げる
清める	清める
済ませる	済ませる
減じる	減じる
温める	温める
渫える	渫える
湛える	湛える
湧き出る	湧き出る
湿気る	湿気る
満ちる	満ちる
満ち満ちる	満ち満ちる
満ち溢れる	満ち溢れる
満ち足りる	満ち足りる
満足りる	満足りる
準える	準える
準じる	準じる
溜める	溜める
溢れる	溢れる
溢れ出る	溢れ出る
溶ける	溶ける
溺れる	溺れる
滅びる	滅びる
滑り出る	滑り出る
滑り落ちる	滑り落ちる
滲ませる	滲ませる
滲みる	滲みる
滲み出る	滲み出る
滴り落ちる	滴り落ちる
漏れる	漏れる
漏れ落ちる	漏れ落ちる
演じる	演じる
漕ぎ回る	漕ぎ回る
漕ぎ寄せる	漕ぎ寄せる
漕ぎ抜ける	漕ぎ抜ける
漕ぎ着ける	漕ぎ着ける
漬ける	漬ける
潜める	潜める
潜らせる	潜らせる
潜り抜ける	潜り抜ける
潤びる	潤びる
潮垂れる	潮垂れる
潰える	潰える
潰れる	潰れる
濡れしょぼたれる	濡れしょぼたれる
濡れる	濡れる
炊ける	炊ける
炒める	炒める
炒り付ける	炒り付ける
炒れる	炒れる
点ける	点ける
点じる	点じる
点てる	点てる
為される	為される
為し遂げる	為し遂げる
為付ける	為付ける
為兼ねる	為兼ねる
為呆ける	為呆ける
為惚ける	為惚ける
為慣れる	為慣れる
為損じる	為損じる
為果せる	為果せる
為果てる	為果てる
為留める	為留める
為終える	為終える
為遂げる	為遂げる
為違える	為違える
為馴れる	為馴れる
焙じる	焙じる
焚き付ける	焚き付ける
焚き染める	焚き染める
焦がれる	焦がれる
焦げる	焦げる
焦れる	焦れる
然らしめる	然らしめる
焼き上げる	焼き上げる
焼き付ける	焼き付ける
焼き捨てる	焼き捨てる
焼き過ぎる	焼き過ぎる
焼ける	焼ける
焼け出される	焼け出される
焼け切れる	焼け切れる
焼け失せる	焼け失せる
焼け爛れる	焼け爛れる
焼け落ちる	焼け落ちる
焼べる	焼べる
焼上げる	焼上げる
焼付ける	焼付ける
焼捨てる	焼捨てる
焼過ぎる	焼過ぎる
煉り上げる	煉り上げる
煉り合せる	煉り合せる
煉り合わせる	煉り合わせる
煉り固める	煉り固める
煎じる	煎じる
煎じ詰める	煎じ詰める
煎り付ける	煎り付ける
煎れる	煎れる
煠める	煠める
煤ける	煤ける
煤びる	煤びる
煤ぼける	煤ぼける
照らし合せる	照らし合せる
照らし合わせる	照らし合わせる
照り付ける	照り付ける
照り合せる	照り合せる
照り合わせる	照り合わせる
照り映える	照り映える
照れる	照れる
照付ける	照付ける
照合せる	照合せる
照合わせる	照合わせる
照映える	照映える
煩わせる	煩わせる
煮える	煮える
煮え零れる	煮え零れる
煮る	煮る
煮上げる	煮上げる
煮付ける	煮付ける
煮合せる	煮合せる
煮合わせる	煮合わせる
煮含める	煮含める
煮染める	煮染める
煮立たせる	煮立たせる
煮立てる	煮立てる
煮詰める	煮詰める
煮零れる	煮零れる
煽ぎ立てる	煽ぎ立てる
煽てる	煽てる
煽り付ける	煽り付ける
煽り立てる	煽り立てる
熅れる	熅れる
熟える	熟える
熟れる	熟れる
熬れる	熬れる
熱れる	熱れる
熾きる	熾きる
燃える	燃える
燃え尽きる	燃え尽きる
燃尽きる	燃尽きる
燻べる	燻べる
燻らせる	燻らせる
爆ぜる	爆ぜる
爛れる	爛れる
爪立てる	爪立てる
片付ける	片付ける
片寄せる	片寄せる
物寂びる	物寂びる
物寂れる	物寂れる
物慣れる	物慣れる
物見る	物見る
物足りる	物足りる
物馴れる	物馴れる
特徴付ける	特徴付ける
特色付ける	特色付ける
狂れる	狂れる
狂わせる	狂わせる
狎れる	狎れる
狙い定める	狙い定める
独り言ちる	独り言ちる
狭める	狭める
狼狽える	狼狽える
献じる	献じる
獲る	獲る
率いる	率いる
率る	率る
現じる	現じる
現れる	現れる
現れる（現われる）	現れる（現われる）
現れ出る	現れ出る
理屈付ける	理屈付ける
甘える	甘える
甘たれる	甘たれる
甘ったれる	甘ったれる
甘んじる	甘んじる
生える	生える
生え出る	生え出る
生きる	生きる
生き別れる	生き別れる
生き存える	生き存える
生き延びる	生き延びる
生き長らえる	生き長らえる
生ける	生ける
生じる	生じる
生へる	生へる
生まれる	生まれる
生まれ出る	生まれ出る
生まれ合せる	生まれ合せる
生まれ合わせる	生まれ合わせる
生まれ落ちる	生まれ落ちる
生み付ける	生み付ける
生み分ける	生み分ける
生れる	生れる
生れ出る	生れ出る
生れ合せる	生れ合せる
生れ合わせる	生れ合わせる
生れ落ちる	生れ落ちる
生別れる	生別れる
生延びる	生延びる
生長らえる	生長らえる
産まれる	産まれる
産み付ける	産み付ける
産れる	産れる
用いる	用いる
用立てる	用立てる
田舎びる	田舎びる
田舎染みる	田舎染みる
申し上げる	申し上げる
申し付ける	申し付ける
申し伝える	申し伝える
申し入れる	申し入れる
申し兼ねる	申し兼ねる
申し出でる	申し出でる
申し出る	申し出る
申し受ける	申し受ける
申し合せる	申し合せる
申し合わせる	申し合わせる
申し添える	申し添える
申し立てる	申し立てる
申し聞かせる	申し聞かせる
申し聞ける	申し聞ける
申し述べる	申し述べる
申し遅れる	申し遅れる
申上げる	申上げる
申付ける	申付ける
申伝える	申伝える
申入れる	申入れる
申兼ねる	申兼ねる
申出る	申出る
申受ける	申受ける
申合せる	申合せる
申合わせる	申合わせる
申添える	申添える
申立てる	申立てる
申聞かせる	申聞かせる
申聞ける	申聞ける
申述べる	申述べる
申遅れる	申遅れる
畏れる	畏れる
留める	留める
番える	番える
畳み上げる	畳み上げる
畳み掛ける	畳み掛ける
疎んじる	疎んじる
疲れる	疲れる
疲れ果てる	疲れ果てる
疵付ける	疵付ける
痂せる	痂せる
病み耄ける	病み耄ける
病める	病める
痛める	痛める
痛め付ける	痛め付ける
痞える	痞える
痩ける	痩ける
痩せこける	痩せこける
痩せさらばえる	痩せさらばえる
痩せさらぼえる	痩せさらぼえる
痩せる	痩せる
痩せ枯れる	痩せ枯れる
痩せ衰える	痩せ衰える
痴れる	痴れる
痺れる	痺れる
瘠せる	瘠せる
癈いる	癈いる
癒える	癒える
癒る	癒る
登り詰める	登り詰める
白ける	白ける
白げる	白げる
白茶ける	白茶ける
皺びる	皺びる
皺める	皺める
皺立てる	皺立てる
盗み見る	盗み見る
盛り上げる	盛り上げる
盛り下げる	盛り下げる
盛り付ける	盛り付ける
盛り合せる	盛り合せる
盛り合わせる	盛り合わせる
盛り立てる	盛り立てる
盛上げる	盛上げる
盛下げる	盛下げる
盛付ける	盛付ける
盛合せる	盛合せる
盛合わせる	盛合わせる
盛立てる	盛立てる
盪ける	盪ける
目っける	目っける
目付ける	目付ける
目慣れる	目慣れる
目掛ける	目掛ける
目覚める	目覚める
目馴れる	目馴れる
盲いる	盲いる
相似る	相似る
相勤める	相勤める
相携える	相携える
相果てる	相果てる
相見る	相見る
相通じる	相通じる
省みる	省みる
眇める	眇める
真似る	真似る
眠らせる	眠らせる
眠りこける	眠りこける
眩れる	眩れる
眺める	眺める
着ける	着ける
着せる	着せる
着せ掛ける	着せ掛ける
着せ替える	着せ替える
着る	着る
着れる	着れる
着付ける	着付ける
着崩れる	着崩れる
着慣れる	着慣れる
着捨てる	着捨てる
着換える	着換える
着替える	着替える
着棄てる	着棄てる
着脹れる	着脹れる
着膨れる	着膨れる
着馴れる	着馴れる
睡らせる	睡らせる
睨まえる	睨まえる
睨み付ける	睨み付ける
睨み合せる	睨み合せる
睨み合わせる	睨み合わせる
睨み据える	睨み据える
睨める	睨める
睨め付ける	睨め付ける
知らせる	知らせる
知れる	知れる
知初める	知初める
矯める	矯める
研ぎ上げる	研ぎ上げる
研上げる	研上げる
砕ける	砕ける
破ける	破ける
破れる	破れる
確かめる	確かめる
磨き上げる	磨き上げる
磨き立てる	磨き立てる
磨れる	磨れる
示し合せる	示し合せる
示し合わせる	示し合わせる
祈り上げる	祈り上げる
祓い清める	祓い清める
神さびる	神さびる
祭り上げる	祭り上げる
禁じる	禁じる
禁める	禁める
禿げちょろける	禿げちょろける
禿げる	禿げる
禿びる	禿びる
秀でる	秀でる
秘める	秘める
秩序立てる	秩序立てる
称える	称える
程経る	程経る
積み上げる	積み上げる
積み換える	積み換える
積み替える	積み替える
積み立てる	積み立てる
積み重ねる	積み重ねる
積上げる	積上げる
積換える	積換える
積替える	積替える
積立てる	積立てる
積重ねる	積重ねる
穢れる	穢れる
究める	究める
空ける	空ける
空っ惚ける	空っ惚ける
空惚ける	空惚ける
穿き違える	穿き違える
突い居る	突い居る
突き上げる	突き上げる
突き付ける	突き付ける
突き入れる	突き入れる
突き出る	突き出る
突き合せる	突き合せる
突き合わせる	突き合わせる
突き固める	突き固める
突き当てる	突き当てる
突き抜ける	突き抜ける
突き据える	突き据える
突き掛ける	突き掛ける
突き止める	突き止める
突き立てる	突き立てる
突き詰める	突き詰める
突き退ける	突き退ける
突き除ける	突き除ける
突っ包める	突っ包める
突っ含める	突っ含める
突っ括める	突っ括める
突っ掛ける	突っ掛ける
突っ撥ねる	突っ撥ねる
突っ立てる	突っ立てる
突上げる	突上げる
突付ける	突付ける
突入れる	突入れる
突出る	突出る
突合せる	突合せる
突合わせる	突合わせる
突固める	突固める
突当てる	突当てる
突抜ける	突抜ける
突据える	突据える
突掛ける	突掛ける
突止める	突止める
突立てる	突立てる
突詰める	突詰める
窄ける	窄ける
窄める	窄める
窘める	窘める
窪める	窪める
窮める	窮める
窶れる	窶れる
立ち上げる	立ち上げる
立ち切れる	立ち切れる
立ち別れる	立ち別れる
立ち居る	立ち居る
立ち後れる	立ち後れる
立ち枯れる	立ち枯れる
立ち籠める	立ち籠める
立ち続ける	立ち続ける
立ち草臥れる	立ち草臥れる
立ち見る	立ち見る
立ち越える	立ち越える
立ち込める	立ち込める
立ち遅れる	立ち遅れる
立ち顕れる	立ち顕れる
立てる	立てる
立て付ける	立て付ける
立て懸ける	立て懸ける
立て掛ける	立て掛ける
立て替える	立て替える
立て籠める	立て籠める
立て込める	立て込める
立上げる	立上げる
立並べる	立並べる
立付ける	立付ける
立別れる	立別れる
立後れる	立後れる
立懸ける	立懸ける
立掛ける	立掛ける
立替える	立替える
立枯れる	立枯れる
立消える	立消える
立現れる	立現れる
立籠める	立籠める
立続ける	立続ける
立越える	立越える
立込める	立込める
立遅れる	立遅れる
竦める	竦める
竭きる	竭きる
競べる	競べる
競り上げる	競り上げる
競り負ける	競り負ける
競上げる	競上げる
競負ける	競負ける
笑い崩れる	笑い崩れる
笑い転ける	笑い転ける
笑い転げる	笑い転げる
笑える	笑える
笑み割れる	笑み割れる
笑み崩れる	笑み崩れる
笑み溢れる	笑み溢れる
笑わせる	笑わせる
笑割れる	笑割れる
筋立てる	筋立てる
答える	答える
算える	算える
箝げる	箝げる
箝げ替える	箝げ替える
築き上げる	築き上げる
築き立てる	築き立てる
篩い分ける	篩い分ける
簸る	簸る
籠める	籠める
粗ける	粗ける
精げる	精げる
糅てる	糅てる
系統立てる	系統立てる
約める	約める
紊れる	紊れる
納める	納める
紐付ける	紐付ける
紛える	紛える
紛らせる	紛らせる
紛れる	紛れる
素っ恍ける	素っ恍ける
素っ惚ける	素っ惚ける
紮げる	紮げる
細める	細める
終える	終える
組み上げる	組み上げる
組み伏せる	組み伏せる
組み入れる	組み入れる
組み合せる	組み合せる
組み合わせる	組み合わせる
組み換える	組み換える
組み替える	組み替える
組み立てる	組み立てる
組み違える	組み違える
組上げる	組上げる
組伏せる	組伏せる
組入れる	組入れる
組合せる	組合せる
組合わせる	組合わせる
組換える	組換える
組替える	組替える
組止める	組止める
組留める	組留める
組立てる	組立てる
組違える	組違える
絆される	絆される
経る	経る
絎ける	絎ける
結い上げる	結い上げる
結い付ける	結い付ける
結い絡げる	結い絡げる
結える	結える
結しる	結しる
結ばれる	結ばれる
結び付ける	結び付ける
結び合せる	結び合せる
結び合わせる	結び合わせる
結ぼれる	結ぼれる
結わい付ける	結わい付ける
結わえる	結わえる
結わえ付ける	結わえ付ける
結上げる	結上げる
結付ける	結付ける
結論付ける	結論付ける
絞める	絞める
絞り上げる	絞り上げる
絡げる	絡げる
絡ませる	絡ませる
絡み付ける	絡み付ける
絡める	絡める
統べる	統べる
絶える	絶える
絶え果てる	絶え果てる
絶果てる	絶果てる
継ぎ合せる	継ぎ合せる
継ぎ合わせる	継ぎ合わせる
継ぎ立てる	継ぎ立てる
継合せる	継合せる
継合わせる	継合わせる
継立てる	継立てる
続ける	続ける
綜る	綜る
綯い交ぜる	綯い交ぜる
綯い合せる	綯い合せる
綰げる	綰げる
綰ねる	綰ねる
綴じる	綴じる
綴じ付ける	綴じ付ける
綴じ合せる	綴じ合せる
綴じ合わせる	綴じ合わせる
綴り合せる	綴り合せる
綴り合わせる	綴り合わせる
綻ばせる	綻ばせる
綻びる	綻びる
総べる	総べる
締める	締める
締め上げる	締め上げる
締め付ける	締め付ける
締め寄せる	締め寄せる
締上げる	締上げる
締付ける	締付ける
締寄せる	締寄せる
編み上げる	編み上げる
編み立てる	編み立てる
編上げる	編上げる
編立てる	編立てる
緩める	緩める
練り上げる	練り上げる
練り合せる	練り合せる
練り合わせる	練り合わせる
練り固める	練り固める
練れける	練れける
練れる	練れる
練上げる	練上げる
練合せる	練合せる
練合わせる	練合わせる
練固める	練固める
縁付ける	縁付ける
縊れる	縊れる
縒り合せる	縒り合せる
縒り合わせる	縒り合わせる
縒れる	縒れる
縛める	縛める
縛り上げる	縛り上げる
縛り付ける	縛り付ける
縫い上げる	縫い上げる
縫い付ける	縫い付ける
縫い合せる	縫い合せる
縫い合わせる	縫い合わせる
縫上げる	縫上げる
縫付ける	縫付ける
縫入れる	縫入れる
縫合せる	縫合せる
縫合わせる	縫合わせる
縮くれる	縮くれる
縮ける	縮ける
縮こめる	縮こめる
縮める	縮める
縮らせる	縮らせる
縮れる	縮れる
縺れる	縺れる
繋ぎ止める	繋ぎ止める
繋げる	繋げる
織り上げる	織り上げる
織り交ぜる	織り交ぜる
織交ぜる	織交ぜる
繫ぎ止める	繫ぎ止める
繫げる	繫げる
繰り上げる	繰り上げる
繰り下げる	繰り下げる
繰り入れる	繰り入れる
繰り合せる	繰り合せる
繰り合わせる	繰り合わせる
繰り寄せる	繰り寄せる
繰り広げる	繰り広げる
繰り延べる	繰り延べる
繰り替える	繰り替える
繰上げる	繰上げる
繰下げる	繰下げる
繰入れる	繰入れる
繰合せる	繰合せる
繰合わせる	繰合わせる
繰寄せる	繰寄せる
繰広げる	繰広げる
繰延べる	繰延べる
繰替える	繰替える
纏べる	纏べる
纏める	纏める
纏め上げる	纏め上げる
缺ける	缺ける
罅ぜる	罅ぜる
罅れる	罅れる
罅割れる	罅割れる
置き忘れる	置き忘れる
置き捨てる	置き捨てる
置き換える	置き換える
置き替える	置き替える
置忘れる	置忘れる
置捨てる	置捨てる
置換える	置換える
置替える	置替える
罷める	罷める
罷り出る	罷り出る
羞じる	羞じる
群れる	群れる
義務付ける	義務付ける
翁さびる	翁さびる
翳める	翳める
翻れる	翻れる
老いさびる	老いさびる
老いさらばえる	老いさらばえる
老いる	老いる
老い朽ちる	老い朽ちる
老い果てる	老い果てる
老い耄れる	老い耄れる
老ける	老ける
老朽ちる	老朽ちる
老果てる	老果てる
考える	考える
考え合せる	考え合せる
考え合わせる	考え合わせる
耄ける	耄ける
耄れる	耄れる
耐える	耐える
耳慣れる	耳慣れる
耳馴れる	耳馴れる
聞える	聞える
聞かせる	聞かせる
聞きそびれる	聞きそびれる
聞き付ける	聞き付ける
聞き伝える	聞き伝える
聞き入れる	聞き入れる
聞き分ける	聞き分ける
聞き占める	聞き占める
聞き合せる	聞き合せる
聞き合わせる	聞き合わせる
聞き咎める	聞き咎める
聞き定める	聞き定める
聞き届ける	聞き届ける
聞き忘れる	聞き忘れる
聞き惚れる	聞き惚れる
聞き慣れる	聞き慣れる
聞き捨てる	聞き捨てる
聞き留める	聞き留める
聞き蕩れる	聞き蕩れる
聞き覚える	聞き覚える
聞き違える	聞き違える
聞き飽きる	聞き飽きる
聞き馴れる	聞き馴れる
聞ける	聞ける
聞こえる	聞こえる
聞付ける	聞付ける
聞伝える	聞伝える
聞入れる	聞入れる
聞分ける	聞分ける
聞合せる	聞合せる
聞合わせる	聞合わせる
聞定める	聞定める
聞届ける	聞届ける
聞忘れる	聞忘れる
聞慣れる	聞慣れる
聞捨てる	聞捨てる
聞果てる	聞果てる
聞留める	聞留める
聞覚える	聞覚える
聞違える	聞違える
聞飽きる	聞飽きる
聞飽る	聞飽る
聳える	聳える
聴き惚れる	聴き惚れる
職過ぎる	職過ぎる
肥える	肥える
肩げる	肩げる
肯ける	肯ける
肯んじる	肯んじる
育てる	育てる
育て上げる	育て上げる
背ける	背ける
背負ってる	背負ってる
胯越える	胯越える
脅える	脅える
脅し付ける	脅し付ける
脇掛ける	脇掛ける
脱ぎ捨てる	脱ぎ捨てる
脱ぎ掛ける	脱ぎ掛ける
脱け出る	脱け出る
脱げる	脱げる
脱捨てる	脱捨てる
脱掛ける	脱掛ける
脱換える	脱換える
脹らせる	脹らせる
脹らめる	脹らめる
脹れる	脹れる
腐れる	腐れる
腑抜ける	腑抜ける
腫れる	腫れる
腰掛ける	腰掛ける
腹立てる	腹立てる
膨らせる	膨らせる
膨らめる	膨らめる
膨れる	膨れる
自惚れる	自惚れる
臭わせる	臭わせる
舁き上げる	舁き上げる
舁き入れる	舁き入れる
舂き交ぜる	舂き交ぜる
興じる	興じる
興醒める	興醒める
舐める	舐める
舞い納める	舞い納める
舞い落ちる	舞い落ちる
舞い降りる	舞い降りる
舞納める	舞納める
舞落ちる	舞落ちる
舞降りる	舞降りる
艀ける	艀ける
色付ける	色付ける
色褪せる	色褪せる
芝居染みる	芝居染みる
芽生える	芽生える
苛める	苛める
苛れる	苛れる
苛立てる	苛立てる
若気る	若気る
苦しめる	苦しめる
苦める	苦める
茹でる	茹でる
茹で上げる	茹で上げる
草臥れる	草臥れる
荒くれる	荒くれる
荒げる	荒げる
荒びる	荒びる
荒びれる	荒びれる
荒らげる	荒らげる
荒れる	荒れる
荒れ果てる	荒れ果てる
荒立てる	荒立てる
萌える	萌える
萌え出る	萌え出る
萎える	萎える
萎びる	萎びる
萎れる	萎れる
落し入れる	落し入れる
落ちぶれる	落ちぶれる
落ちる	落ちる
落ち付ける	落ち付ける
落ち居る	落ち居る
落ち延びる	落ち延びる
落ち着ける	落ち着ける
落っこちる	落っこちる
落とし入れる	落とし入れる
落付ける	落付ける
落延びる	落延びる
落着ける	落着ける
落魄れる	落魄れる
著る	著る
葺き替える	葺き替える
蒔き付ける	蒔き付ける
蒸ける	蒸ける
蒸れる	蒸れる
蒼褪める	蒼褪める
蓄える	蓄える
蓬ける	蓬ける
蔵い忘れる	蔵い忘れる
蕩ける	蕩ける
薄ぼける	薄ぼける
薄める	薄める
薄れる	薄れる
薄汚れる	薄汚れる
薙ぎ伏せる	薙ぎ伏せる
薙ぎ立てる	薙ぎ立てる
薦める	薦める
薫き染める	薫き染める
薫き込める	薫き込める
薫じる	薫じる
薫らせる	薫らせる
虐げる	虐げる
虐める	虐める
虚ける	虚ける
蛻ける	蛻ける
融ける	融ける
行き付ける	行き付ける
行き別れる	行き別れる
行き合せる	行き合せる
行き合わせる	行き合わせる
行き廻る	行き廻る
行き暮れる	行き暮れる
行き過ぎる	行き過ぎる
行き違える	行き違える
行ける	行ける
行われる	行われる
行われる（行なわれる）	行われる（行なわれる）
行付ける	行付ける
行別れる	行別れる
行合せる	行合せる
行合わせる	行合わせる
行暮れる	行暮れる
行詰める	行詰める
行過ぎる	行過ぎる
行違える	行違える
衝き上げる	衝き上げる
表れる	表れる
表れる（表われる）	表れる（表われる）
表立てる	表立てる
衰える	衰える
被ける	被ける
被せる	被せる
裁ち合せる	裁ち合せる
裁ち合わせる	裁ち合わせる
裁合せる	裁合せる
裁合わせる	裁合わせる
裂ける	裂ける
裏付ける	裏付ける
褒める	褒める
褒め上げる	褒め上げる
褒め称える	褒め称える
褒め立てる	褒め立てる
褪せる	褪せる
褪める	褪める
襤褸ける	襤褸ける
覆い被せる	覆い被せる
見える	見える
見せる	見せる
見せ付ける	見せ付ける
見せ掛ける	見せ掛ける
見る	見る
見れる	見れる
見上げる	見上げる
見下げる	見下げる
見下げ果てる	見下げ果てる
見付ける	見付ける
見兼ねる	見兼ねる
見分ける	見分ける
見切れる	見切れる
見初める	見初める
見受ける	見受ける
見合せる	見合せる
見合わせる	見合わせる
見咎める	見咎める
見変える	見変える
見定める	見定める
見届ける	見届ける
見忘れる	見忘れる
見惚れる	見惚れる
見慣れる	見慣れる
見捨てる	見捨てる
見据える	見据える
見掛ける	見掛ける
見損じる	見損じる
見替える	見替える
見果てる	見果てる
見棄てる	見棄てる
見極める	見極める
見比べる	見比べる
見立てる	見立てる
見蕩れる	見蕩れる
見覚える	見覚える
見詰める	見詰める
見較べる	見較べる
見逸れる	見逸れる
見違える	見違える
見間違える	見間違える
見飽きる	見飽きる
見馴れる	見馴れる
視る	視る
覗かせる	覗かせる
覗き見る	覗き見る
覗ける	覗ける
覘かせる	覘かせる
覚える	覚える
覚める	覚める
観じる	観じる
観る	観る
角立てる	角立てる
解ける	解ける
解せる	解せる
解れる	解れる
触れる	触れる
言いそそくれる	言いそそくれる
言いそびれる	言いそびれる
言い丸める	言い丸める
言い付ける	言い付ける
言い伏せる	言い伏せる
言い伝える	言い伝える
言い入れる	言い入れる
言い兼ねる	言い兼ねる
言い分ける	言い分ける
言い包める	言い包める
言い合せる	言い合せる
言い合わせる	言い合わせる
言い含める	言い含める
言い告げる	言い告げる
言い固める	言い固める
言い始める	言い始める
言い広める	言い広める
言い当てる	言い当てる
言い慣れる	言い慣れる
言い抜ける	言い抜ける
言い拵える	言い拵える
言い捨てる	言い捨てる
言い掛ける	言い掛ける
言い換える	言い換える
言い替える	言い替える
言い添える	言い添える
言い白ける	言い白ける
言い立てる	言い立てる
言い竦める	言い竦める
言い籠める	言い籠める
言い続ける	言い続ける
言い聞かせる	言い聞かせる
言い被せる	言い被せる
言い詰める	言い詰める
言い負ける	言い負ける
言い退ける	言い退ける
言い逃れる	言い逃れる
言い連ねる	言い連ねる
言い逸れる	言い逸れる
言い遅れる	言い遅れる
言い過ぎる	言い過ぎる
言い違える	言い違える
言い馴れる	言い馴れる
言い黒める	言い黒める
言える	言える
言っ付ける	言っ付ける
言わせる	言わせる
言丸める	言丸める
言付ける	言付ける
言伏せる	言伏せる
言伝える	言伝える
言入れる	言入れる
言兼ねる	言兼ねる
言分ける	言分ける
言合せる	言合せる
言合わせる	言合わせる
言含める	言含める
言告げる	言告げる
言固める	言固める
言始める	言始める
言寄せる	言寄せる
言広める	言広める
言当てる	言当てる
言後れる	言後れる
言慣れる	言慣れる
言抜ける	言抜ける
言捨てる	言捨てる
言掛ける	言掛ける
言換える	言換える
言替える	言替える
言添える	言添える
言白ける	言白ける
言立てる	言立てる
言続ける	言続ける
言聞かせる	言聞かせる
言詰める	言詰める
言負ける	言負ける
言逃れる	言逃れる
言連ねる	言連ねる
言遅れる	言遅れる
言過ぎる	言過ぎる
言違える	言違える
計り兼ねる	計り兼ねる
訊ねる	訊ねる
託ける	託ける
託つける	託つける
訪ねる	訪ねる
訪れる	訪れる
設える	設える
設ける	設ける
許りる	許りる
許れる	許れる
訴える	訴える
診る	診る
証拠立てる	証拠立てる
詠じる	詠じる
詠み入れる	詠み入れる
詠入れる	詠入れる
詠捨てる	詠捨てる
詣でる	詣でる
試みる	試みる
詫びる	詫びる
詰める	詰める
詰め合せる	詰め合せる
詰め合わせる	詰め合わせる
詰め寄せる	詰め寄せる
詰め掛ける	詰め掛ける
詰め替える	詰め替える
詰合せる	詰合せる
詰合わせる	詰合わせる
詰寄せる	詰寄せる
詰掛ける	詰掛ける
詰替える	詰替える
話し掛ける	話し掛ける
話せる	話せる
誂える	誂える
誉める	誉める
誉め上げる	誉め上げる
誉め称える	誉め称える
誉め立てる	誉め立てる
認める	認める
誘い合せる	誘い合せる
誘い合わせる	誘い合わせる
誘い掛ける	誘い掛ける
誘き入れる	誘き入れる
誘き寄せる	誘き寄せる
語り伝える	語り伝える
語り掛ける	語り掛ける
誡める	誡める
誣いる	誣いる
説き付ける	説き付ける
説き伏せる	説き伏せる
説き分ける	説き分ける
説き勧める	説き勧める
説き聞かせる	説き聞かせる
説付ける	説付ける
説伏せる	説伏せる
説分ける	説分ける
説勧める	説勧める
説明らめる	説明らめる
説聞かせる	説聞かせる
読ませる	読ませる
読み上げる	読み上げる
読み付ける	読み付ける
読み合せる	読み合せる
読み合わせる	読み合わせる
読み慣れる	読み慣れる
読み捨てる	読み捨てる
読み掛ける	読み掛ける
読み替える	読み替える
読み比べる	読み比べる
読み立てる	読み立てる
読み聞かせる	読み聞かせる
読み違える	読み違える
読み馴れる	読み馴れる
読める	読める
読上げる	読上げる
読付ける	読付ける
読合せる	読合せる
読合わせる	読合わせる
読慣れる	読慣れる
読捨てる	読捨てる
読掛ける	読掛ける
読替える	読替える
読比べる	読比べる
読立てる	読立てる
読聞かせる	読聞かせる
読違える	読違える
読間違える	読間違える
調える	調える
調べる	調べる
調べ上げる	調べ上げる
談じる	談じる
談じ付ける	談じ付ける
請い受ける	請い受ける
請ける	請ける
請じる	請じる
請じ入れる	請じ入れる
論じる	論じる
諜し合せる	諜し合せる
諜じ合せる	諜じ合せる
諜じ合わせる	諜じ合わせる
諦める	諦める
諫める	諫める
諳んじる	諳んじる
講じる	講じる
謳い上げる	謳い上げる
謳い揚げる	謳い揚げる
謳われる	謳われる
警める	警める
警固見る	警固見る
譬える	譬える
譲り受ける	譲り受ける
負ける	負ける
責める	責める
責め付ける	責め付ける
責め立てる	責め立てる
責付ける	責付ける
責掛ける	責掛ける
責立てる	責立てる
貯える	貯える
貰い下げる	貰い下げる
貰い受ける	貰い受ける
貰い溜める	貰い溜める
貶める	貶める
買い上げる	買い上げる
買い与える	買い与える
買い付ける	買い付ける
買い入れる	買い入れる
買い占める	買い占める
買い受ける	買い受ける
買い控える	買い控える
買い揃える	買い揃える
買い換える	買い換える
買い整える	買い整える
買い替える	買い替える
買い求める	買い求める
買い立てる	買い立てる
買い調える	買い調える
買い負ける	買い負ける
買い集める	買い集める
買上げる	買上げる
買与える	買与える
買付ける	買付ける
買入れる	買入れる
買占める	買占める
買受ける	買受ける
買控える	買控える
買換える	買換える
買整える	買整える
買替える	買替える
買求める	買求める
買立てる	買立てる
買調える	買調える
買負ける	買負ける
買集める	買集める
貸し下げる	貸し下げる
貸し付ける	貸し付ける
貸下げる	貸下げる
貸与える	貸与える
貸付ける	貸付ける
費える	費える
貼り付ける	貼り付ける
貼り合せる	貼り合せる
貼り合わせる	貼り合わせる
貼り替える	貼り替える
貼付ける	貼付ける
貼替える	貼替える
賞でる	賞でる
賤しめる	賤しめる
賭ける	賭ける
贏ち得る	贏ち得る
赤める	赤める
赤らめる	赤らめる
赤焼ける	赤焼ける
赤茶ける	赤茶ける
赦れる	赦れる
赧める	赧める
走らせる	走らせる
走り抜ける	走り抜ける
走り過ぎる	走り過ぎる
起きる	起きる
超える	超える
越える	越える
足し合せる	足し合せる
足し合わせる	足し合わせる
足りる	足りる
跡付ける	跡付ける
跡切れる	跡切れる
跡絶える	跡絶える
跨げる	跨げる
跨越える	跨越える
跳ねる	跳ねる
跳ね起きる	跳ね起きる
跳び越える	跳び越える
跳越える	跳越える
踏まえる	踏まえる
踏み付ける	踏み付ける
踏み入れる	踏み入れる
踏み分ける	踏み分ける
踏み固める	踏み固める
踏み堪える	踏み堪える
踏み替える	踏み替える
踏み立てる	踏み立てる
踏み締める	踏み締める
踏み越える	踏み越える
踏み違える	踏み違える
踏み開ける	踏み開ける
踏んまえる	踏んまえる
踏ん付ける	踏ん付ける
踏付ける	踏付ける
踏入れる	踏入れる
踏分ける	踏分ける
踏固める	踏固める
踏換える	踏換える
踏替える	踏替える
踏立てる	踏立てる
踏締める	踏締める
踏越える	踏越える
踏違える	踏違える
蹌踉ける	蹌踉ける
蹣跚ける	蹣跚ける
蹴り上げる	蹴り上げる
蹴る	蹴る
蹴ゑる	蹴ゑる
蹴上げる	蹴上げる
蹴付ける	蹴付ける
蹴立てる	蹴立てる
蹴退ける	蹴退ける
蹴違える	蹴違える
躍り出る	躍り出る
躙り出る	躙り出る
身悶える	身悶える
身構える	身構える
躾ける	躾ける
軋ませる	軋ませる
転がり落ちる	転がり落ちる
転ける	転ける
転げる	転げる
転げ落ちる	転げ落ちる
転じる	転じる
軽しめる	軽しめる
軽んじる	軽んじる
較べる	較べる
載せる	載せる
載せ掛ける	載せ掛ける
載っける	載っける
輔ける	輔ける
辞める	辞める
辨える	辨える
辨じる	辨じる
辯じる	辯じる
辱める	辱める
込み上げる	込み上げる
込める	込める
込上げる	込上げる
迎える	迎える
迎え入れる	迎え入れる
近付ける	近付ける
近寄せる	近寄せる
迫り上げる	迫り上げる
迫り立てる	迫り立てる
迫り詰める	迫り詰める
述べる	述べる
述べ立てる	述べ立てる
追い上げる	追い上げる
追い掛ける	追い掛ける
追い求める	追い求める
追い立てる	追い立てる
追い詰める	追い詰める
追い退ける	追い退ける
追っ掛ける	追っ掛ける
追っ立てる	追っ立てる
追ん出る	追ん出る
追上げる	追上げる
追掛ける	追掛ける
追求める	追求める
追立てる	追立てる
追詰める	追詰める
退ける	退ける
退治る	退治る
送り付ける	送り付ける
送り届ける	送り届ける
逃げる	逃げる
逃げ失せる	逃げ失せる
逃げ延びる	逃げ延びる
逃げ果せる	逃げ果せる
逃げ落ちる	逃げ落ちる
逃げ遅れる	逃げ遅れる
逃げ隠れる	逃げ隠れる
逃れる	逃れる
逃延びる	逃延びる
逃後れる	逃後れる
逃落ちる	逃落ちる
逃遅れる	逃遅れる
逃隠れる	逃隠れる
逆上せる	逆上せる
逆立てる	逆立てる
透かし見る	透かし見る
透ける	透ける
途切らせる	途切らせる
途切れる	途切れる
途絶える	途絶える
這い出る	這い出る
通い詰める	通い詰める
通じる	通じる
通り合せる	通り合せる
通り合わせる	通り合わせる
通り抜ける	通り抜ける
通り過ぎる	通り過ぎる
速める	速める
造り立てる	造り立てる
逢い見る	逢い見る
逢わせる	逢わせる
連ねる	連ねる
連べ掛ける	連べ掛ける
連れる	連れる
進じる	進じる
進ぜる	進ぜる
進み出る	進み出る
進める	進める
逸れる	逸れる
遁れる	遁れる
遂げる	遂げる
遂せる	遂せる
遅らせる	遅らせる
遅れる	遅れる
遊ばせる	遊ばせる
遊び呆ける	遊び呆ける
遊び戯れる	遊び戯れる
運命付ける	運命付ける
過ぎる	過ぎる
道化る	道化る
達しる	達しる
違える	違える
遠ざける	遠ざける
遠退ける	遠退ける
遣って退ける	遣って退ける
遣っ付ける	遣っ付ける
遣らせる	遣らせる
遣り上げる	遣り上げる
遣り付ける	遣り付ける
遣り掛ける	遣り掛ける
遣り損じる	遣り損じる
遣り替える	遣り替える
遣り果せる	遣り果せる
遣り込める	遣り込める
遣り退ける	遣り退ける
遣り遂げる	遣り遂げる
遣り過ぎる	遣り過ぎる
遣り違える	遣り違える
遣わされる	遣わされる
適える	適える
遭せる	遭せる
遭わせる	遭わせる
選り分ける	選り分ける
避ける	避ける
邀える	邀える
都びる	都びる
鄙びる	鄙びる
酌み分ける	酌み分ける
酌分ける	酌分ける
酔い潰れる	酔い潰れる
酔い痴れる	酔い痴れる
酬いる	酬いる
醒める	醒める
里馴れる	里馴れる
重くれる	重くれる
重ねる	重ねる
重んじる	重んじる
釣られる	釣られる
釣り上げる	釣り上げる
釣り下げる	釣り下げる
釣れる	釣れる
釣上げる	釣上げる
釣下げる	釣下げる
釣瓶掛ける	釣瓶掛ける
銘じる	銘じる
銜える	銜える
銜める	銜める
銹びる	銹びる
鋳る	鋳る
鋳掛ける	鋳掛ける
錆びる	錆びる
錬り上げる	錬り上げる
鍛える	鍛える
鍛え上げる	鍛え上げる
鎖し固める	鎖し固める
鎖し籠める	鎖し籠める
鎮める	鎮める
鏤める	鏤める
鑑みる	鑑みる
鑑る	鑑る
鑒みる	鑒みる
長ける	長ける
長じる	長じる
長らえる	長らえる
閉じる	閉じる
閉じ込める	閉じ込める
閉てる	閉てる
閉て込める	閉て込める
閉める	閉める
閉込める	閉込める
閊える	閊える
開ける	開ける
開け広げる	開け広げる
間に合せる	間に合せる
間に合わせる	間に合わせる
間違える	間違える
関係付ける	関係付ける
関連付ける	関連付ける
闌ける	闌ける
闕ける	闕ける
附ける	附ける
降らせる	降らせる
降りる	降りる
降り籠める	降り籠める
降籠める	降籠める
除ける	除ける
陥れる	陥れる
陳くれる	陳くれる
陳こびる	陳こびる
陳じる	陳じる
陳ねくれる	陳ねくれる
陳ねこびる	陳ねこびる
陳ねる	陳ねる
陳べる	陳べる
随える	随える
隔てる	隔てる
障える	障える
隠れる	隠れる
雅びる	雅びる
集べる	集べる
集める	集める
雇い入れる	雇い入れる
雑える	雑える
雑ぜる	雑ぜる
離れる	離れる
難じる	難じる
雪崩れる	雪崩れる
雪崩落ちる	雪崩落ちる
零れる	零れる
零れ落ちる	零れ落ちる
零落れる	零落れる
震える	震える
震わせる	震わせる
霙れる	霙れる
霜げる	霜げる
霜枯れる	霜枯れる
霽れる	霽れる
青ざめる	青ざめる
青びれる	青びれる
青褪める	青褪める
静める	静める
靠れる	靠れる
靡ける	靡ける
面痩せる	面痩せる
韲える	韲える
響かせる	響かせる
頂ける	頂ける
項垂れる	項垂れる
順序立てる	順序立てる
預ける	預ける
預け入れる	預け入れる
頭抜ける	頭抜ける
頷ける	頷ける
頽れる	頽れる
顕れる	顕れる
願い上げる	願い上げる
願い下げる	願い下げる
願い出る	願い出る
類える	類える
顧みる	顧みる
顰める	顰める
飛び下りる	飛び下りる
飛び出る	飛び出る
飛び抜ける	飛び抜ける
飛び起きる	飛び起きる
飛び越える	飛び越える
飛び跳ねる	飛び跳ねる
飛び降りる	飛び降りる
飛び離れる	飛び離れる
飛下りる	飛下りる
飛出る	飛出る
飛抜ける	飛抜ける
飛起きる	飛起きる
飛越える	飛越える
飛跳ねる	飛跳ねる
飛降りる	飛降りる
飛離れる	飛離れる
食いっ逸れる	食いっ逸れる
食い兼ねる	食い兼ねる
食い厭きる	食い厭きる
食い合せる	食い合せる
食い合わせる	食い合わせる
食い掛ける	食い掛ける
食い止める	食い止める
食い締める	食い締める
食い詰める	食い詰める
食い逸れる	食い逸れる
食い過ぎる	食い過ぎる
食い飽きる	食い飽きる
食える	食える
食べる	食べる
食べれる	食べれる
食べ付ける	食べ付ける
食べ掛ける	食べ掛ける
食べ比べる	食べ比べる
食べ過ぎる	食べ過ぎる
食み出る	食み出る
食らわせる	食らわせる
食わせる	食わせる
食われる	食われる
食兼ねる	食兼ねる
食合せる	食合せる
食合わせる	食合わせる
食掛ける	食掛ける
食止める	食止める
食締める	食締める
食詰める	食詰める
食過ぎる	食過ぎる
食飽きる	食飽きる
飢える	飢える
飲ませる	飲ませる
飲み付ける	飲み付ける
飲み掛ける	飲み掛ける
飲み潰れる	飲み潰れる
飲める	飲める
飲んだくれる	飲んだくれる
飲付ける	飲付ける
飲掛ける	飲掛ける
飲潰れる	飲潰れる
飽かせる	飽かせる
飽きる	飽きる
飽き足りる	飽き足りる
飽足りる	飽足りる
飾り付ける	飾り付ける
飾り立てる	飾り立てる
餓える	餓える
饐える	饐える
饑える	饑える
首肯ける	首肯ける
馬鹿げる	馬鹿げる
馳せる	馳せる
馳せ参じる	馳せ参じる
馳せ着ける	馳せ着ける
馴れる	馴れる
馴れ初める	馴れ初める
駄駄ける	駄駄ける
駆ける	駆ける
駆け付ける	駆け付ける
駆け抜ける	駆け抜ける
駆け降りる	駆け降りる
駆られる	駆られる
駆り立てる	駆り立てる
駆り集める	駆り集める
駆付ける	駆付ける
駆付る	駆付る
駆抜ける	駆抜ける
駆抜る	駆抜る
駆立てる	駆立てる
駆降りる	駆降りる
駆集める	駆集める
駈ける	駈ける
駈け抜ける	駈け抜ける
駈け着ける	駈け着ける
駈け降りる	駈け降りる
騒がせる	騒がせる
騒ぎ立てる	騒ぎ立てる
高じる	高じる
高める	高める
魁ける	魁ける
魂消る	魂消る
魘される	魘される
魘れる	魘れる
魘われる	魘われる
鮾れる	鮾れる
鯘れる	鯘れる
鳴き立てる	鳴き立てる
鳴立てる	鳴立てる
黄昏れる	黄昏れる
黒める	黒める
黴びる	黴びる
黴る	黴る
齭る	齭る
﨟長ける	﨟長ける
﨟闌ける	﨟闌ける
𠮟り付ける	𠮟り付ける
あい果てる	あいはてる
あい果てる	相果てる
あい見る	あいみる
あい見る	相見る
あい見る	逢い見る
あおぎ立てる	あおぎたてる
あおぎ立てる	扇ぎ立てる
あおぎ立てる	煽ぎ立てる
あおぎ見る	あおぎみる
あおぎ見る	仰ぎ見る
あおり付ける	あおりつける
あおり付ける	煽り付ける
あおり立てる	あおりたてる
あおり立てる	煽り立てる
あお向ける	あおむける
あお向ける	仰向ける
あか抜ける	あかぬける
あか抜ける	垢抜ける
あきれ果てる	あきれはてる
あきれ果てる	呆れ果てる
あき足りる	あきたりる
あき足りる	飽き足りる
あき足りる	飽足りる
あけ初める	あけそめる
あけ初める	明け初める
あけ広げる	あけひろげる
あけ広げる	明け広げる
あけ広げる	開け広げる
あけ暮れる	あけくれる
あけ暮れる	明け暮れる
あけ離れる	あけはなれる
あけ離れる	明け離れる
あずけ入れる	あずけいれる
あずけ入れる	預け入れる
あそび呆ける	あそびほうける
あそび呆ける	遊び呆ける
あそび戯れる	あそびたわむれる
あそび戯れる	遊び戯れる
あそび疲れる	あそびつかれる
あそび疲れる	遊び疲れる
あて付ける	あてつける
あて付ける	当て付ける
あて嵌める	あてはめる
あて嵌める	当て嵌める
あと付ける	あとづける
あと付ける	跡付ける
あばき立てる	あばきたてる
あばき立てる	暴き立てる
あびせ掛ける	あびせかける
あびせ掛ける	浴びせ掛ける
あふれおちる	あふれおちる
あふれおちる	あふれ落ちる
あふれ出る	あふれでる
あふれ出る	あふれ出る
あふれ出る	溢れ出る
あふれ落ちる	あふれおちる
あふれ落ちる	あふれ落ちる
あみ上げる	あみあげる
あみ上げる	編み上げる
あみ上げる	編上げる
あみ付ける	あみつける
あみ付ける	編み付ける
あみ入れる	あみいれる
あみ入れる	編み入れる
あみ合わせる	あみあわせる
あみ合わせる	編み合わせる
あみ立てる	あみたてる
あみ立てる	編み立てる
あみ立てる	編立てる
あゆみ出る	あゆみでる
あゆみ出る	歩み出る
あらい上げる	あらいあげる
あらい上げる	洗い上げる
あらい清める	あらいきよめる
あらい清める	洗い清める
あらい立てる	あらいたてる
あらい立てる	洗い立てる
あらわれる（現われる）	あらわれる
あらわれる（現われる）	現れる（現われる）
あらわれ出る	あらわれでる
あらわれ出る	現れ出る
あり合せる	ありあわせる
あり合せる	有り合せる
あり合わせる	ありあわせる
あり合わせる	在り合わせる
あり合わせる	有り合わせる
あり得る	ありえる
あり得る	有り得る
あり触れる	ありふれる
あり触れる	有り触れる
あれ果てる	あれはてる
あれ果てる	荒れ果てる
いい丸める	いいまるめる
いい丸める	言い丸める
いい付ける	いいつける
いい付ける	言い付ける
いい伏せる	いいふせる
いい伏せる	言い伏せる
いい伏せる	言伏せる
いい伝える	いいつたえる
いい伝える	言い伝える
いい伝える	言伝える
いい入れる	いいいれる
いい入れる	言い入れる
いい入れる	言入れる
いい兼ねる	いいかねる
いい兼ねる	言い兼ねる
いい分ける	いいわける
いい分ける	言い分ける
いい分ける	言分ける
いい包める	いいくるめる
いい包める	言い包める
いい合せる	いいあわせる
いい合せる	言い合せる
いい合わせる	いいあわせる
いい合わせる	言い合わせる
いい合わせる	言合わせる
いい含める	いいふくめる
いい含める	言い含める
いい含める	言含める
いい告げる	いいつげる
いい告げる	言い告げる
いい固める	いいかためる
いい固める	言い固める
いい固める	言固める
いい始める	いいはじめる
いい始める	言い始める
いい広める	いいひろめる
いい広める	言い広める
いい広める	言広める
いい当てる	いいあてる
いい当てる	言い当てる
いい当てる	言当てる
いい慣れる	いいなれる
いい慣れる	言い慣れる
いい慣れる	言慣れる
いい抜ける	いいぬける
いい抜ける	言い抜ける
いい抜ける	言抜ける
いい拵える	いいこしらえる
いい拵える	言い拵える
いい捨てる	いいすてる
いい捨てる	言い捨てる
いい捨てる	言捨てる
いい掛ける	いいかける
いい掛ける	言い掛ける
いい掛ける	言掛ける
いい換える	いいかえる
いい換える	言い換える
いい換える	言換える
いい曲げる	いいまげる
いい曲げる	言い曲げる
いい替える	いいかえる
いい替える	言い替える
いい替える	言替える
いい添える	いいそえる
いい添える	言い添える
いい添える	言添える
いい白ける	いいしらける
いい白ける	言い白ける
いい立てる	いいたてる
いい立てる	言い立てる
いい立てる	言立てる
いい竦める	いいすくめる
いい竦める	言い竦める
いい籠める	いいこめる
いい籠める	言い籠める
いい続ける	いいつづける
いい続ける	言い続ける
いい聞かせる	いいきかせる
いい聞かせる	言い聞かせる
いい聞かせる	言聞かせる
いい被せる	いいかぶせる
いい被せる	言い被せる
いい詰める	いいつめる
いい詰める	言い詰める
いい詰める	言詰める
いい負ける	いいまける
いい負ける	言い負ける
いい負ける	言負ける
いい込める	いいこめる
いい込める	言い込める
いい退ける	いいのける
いい退ける	言い退ける
いい逃れる	いいのがれる
いい逃れる	言い逃れる
いい逃れる	言逃れる
いい連ねる	いいつらねる
いい連ねる	言い連ねる
いい連ねる	言連ねる
いい逸れる	いいはぐれる
いい逸れる	言い逸れる
いい遅れる	いいおくれる
いい遅れる	言い遅れる
いい遅れる	言遅れる
いい過ぎる	いいすぎる
いい過ぎる	言い過ぎる
いい過ぎる	言過ぎる
いい違える	いいちがえる
いい違える	言い違える
いい違える	言違える
いい馴れる	いいなれる
いい馴れる	言い馴れる
いい黒める	いいくろめる
いい黒める	言い黒める
いき別れる	いきわかれる
いき別れる	生き別れる
いき別れる	生別れる
いき合わせる	いきあわせる
いき合わせる	行き合わせる
いき存える	いきながらえる
いき存える	生き存える
いき延びる	いきのびる
いき延びる	生き延びる
いき延びる	生延びる
いき絶える	いきたえる
いき絶える	息絶える
いき長らえる	いきながらえる
いき長らえる	生き長らえる
いけ替える	いけかえる
いけ替える	生け替える
いため上げる	いためあげる
いため上げる	炒め上げる
いため付ける	いためつける
いため付ける	痛め付ける
いち付ける	いちづける
いち付ける	位置付ける
いのり上げる	いのりあげる
いのり上げる	祈り上げる
いみ付ける	いみづける
いみ付ける	意味付ける
いり上げる	いりあげる
いり上げる	煎り上げる
いり乱れる	いりみだれる
いり乱れる	入り乱れる
いり乱れる	入乱れる
いり付ける	いりつける
いり付ける	射り付ける
いり付ける	炒り付ける
いり付ける	煎り付ける
いり揚げる	いりあげる
いり揚げる	入り揚げる
いり違える	いりちがえる
いり違える	入り違える
いれ交ぜる	いれまぜる
いれ交ぜる	入れ交ぜる
いれ揚げる	いれあげる
いれ揚げる	入れ揚げる
いれ換える	いれかえる
いれ換える	入れ換える
いれ替える	いれかえる
いれ替える	入れ替える
いれ混ぜる	いれまぜる
いれ混ぜる	入れ混ぜる
いれ込める	いれこめる
いれ込める	入れ込める
いれ違える	いれちがえる
いれ違える	入れ違える
いれ雑ぜる	いれまぜる
いれ雑ぜる	入れ雑ぜる
いろ付ける	いろづける
いろ付ける	色付ける
いんしょう付ける	いんしょうづける
いんしょう付ける	印象付ける
い中てる	いあてる
い中てる	射中てる
い付ける	いつける
い付ける	射付ける
い合せる	いあわせる
い合せる	居合せる
い合わせる	いあわせる
い合わせる	居合わせる
い当てる	いあてる
い当てる	射当てる
い掛ける	いかける
い掛ける	射掛ける
い掛ける	鋳掛ける
い止める	いとめる
い止める	射止める
い流れる	いながれる
い流れる	居流れる
い浸れる	いびたれる
い浸れる	居浸れる
い立てる	いたてる
い立てる	射立てる
い竦める	いすくめる
い竦める	射竦める
うえ付ける	うえつける
うえ付ける	植え付ける
うえ換える	うえかえる
うえ換える	植え換える
うえ換える	植換える
うえ替える	うえかえる
うえ替える	植え替える
うえ替える	植替える
うかび出る	うかびでる
うかび出る	浮かび出る
うかび出る	浮び出る
うかれ出る	うかれでる
うかれ出る	浮かれ出る
うかれ出る	浮れ出る
うき出る	うきでる
うき出る	浮き出る
うき出る	浮出る
うけ付ける	うけつける
うけ付ける	受け付ける
うけ伝える	うけつたえる
うけ伝える	受け伝える
うけ入れる	うけいれる
うけ入れる	受け入れる
うけ入れる	受入れる
うけ取れる	うけとれる
うけ取れる	受け取れる
うけ容れる	うけいれる
うけ容れる	受け容れる
うけ損じる	うけそんじる
うけ損じる	受け損じる
うけ止める	うけとめる
うけ止める	受け止める
うしろ見る	うしろみる
うしろ見る	後ろ見る
うたい上げる	うたいあげる
うたい上げる	歌い上げる
うたい上げる	謳い上げる
うたい掛ける	うたいかける
うたい掛ける	歌い掛ける
うたい揚げる	うたいあげる
うたい揚げる	謳い揚げる
うたい納める	うたいおさめる
うたい納める	歌い納める
うちまける	ぶちまける
うちまける	打ちまける
うち上げる	うちあげる
うち上げる	ぶちあげる
うち上げる	打ち上げる
うち付ける	うちつける
うち付ける	打ち付ける
うち切れる	ぶちきれる
うち切れる	打ち切れる
うち合せる	うちあわせる
うち合せる	打ち合せる
うち合わせる	うちあわせる
うち合わせる	打ち合わせる
うち合わせる	打合わせる
うち始める	うちはじめる
うち始める	打ち始める
うち寄せる	うちよせる
うち寄せる	打ち寄せる
うち寄せる	打寄せる
うち廻る	うちみる
うち廻る	打ち廻る
うち当てる	うちあてる
うち当てる	打ち当てる
うち当てる	打当てる
うち忘れる	うちわすれる
うち忘れる	打ち忘れる
うち忘れる	打忘れる
うち懸ける	うちかける
うち懸ける	打ち懸ける
うち捨てる	うちすてる
うち捨てる	打ち捨てる
うち捨てる	打捨てる
うち据える	うちすえる
うち据える	打ち据える
うち据える	打据える
うち掛ける	うちかける
うち掛ける	打ち掛ける
うち掛ける	打掛ける
うち揚げる	うちあげる
うち揚げる	打ち揚げる
うち揚げる	打揚げる
うち損じる	うちそんじる
うち損じる	打ち損じる
うち明ける	うちあける
うち明ける	ぶちあける
うち明ける	打ち明ける
うち明ける	打明ける
うち替える	うちかえる
うち替える	打ち替える
うち止める	うちとめる
うち止める	打ち止める
うち留める	うちとめる
うち留める	打ち留める
うち留める	打留める
うち眺める	うちながめる
うち眺める	打ち眺める
うち眺める	打眺める
うち立てる	うちたてる
うち立てる	打ち立てる
うち立てる	打立てる
うち紛れる	うちまぎれる
うち紛れる	打紛れる
うち絶える	うちたえる
うち絶える	打ち絶える
うち絶える	打絶える
うち興じる	うちきょうじる
うち興じる	打ち興じる
うち萎れる	うちしおれる
うち萎れる	打ち萎れる
うち見る	うちみる
うち見る	打ち見る
うち見る	打見る
うち解ける	うちとける
うち解ける	打ち解ける
うち解ける	打解ける
うち詫びる	うちわびる
うち詫びる	打ち詫びる
うち負ける	うちまける
うち負ける	打ち負ける
うち連れる	うちつれる
うち連れる	打ち連れる
うち連れる	打連れる
うち過ぎる	うちすぎる
うち過ぎる	打ち過ぎる
うち過ぎる	打過ぎる
うち違える	うちちがえる
うち違える	打ち違える
うち違える	打違える
うち開ける	ぶちあける
うち開ける	打ち開ける
うち震える	うちふるえる
うち震える	打ち震える
うち震える	打震える
うち顰める	うちひそめる
うち顰める	打ち顰める
うったえ出る	うったえでる
うったえ出る	訴え出る
うったえ掛ける	うったえかける
うったえ掛ける	訴え掛ける
うって出る	うってでる
うって出る	打って出る
うつし入れる	うつしいれる
うつし入れる	移し入れる
うつし替える	うつしかえる
うつし替える	移し替える
うつし植える	うつしうえる
うつし植える	移し植える
うまれ出る	うまれでる
うまれ出る	生まれ出る
うまれ出る	生れ出る
うまれ合せる	うまれあわせる
うまれ合せる	生まれ合せる
うまれ合わせる	うまれあわせる
うまれ合わせる	生まれ合わせる
うまれ合わせる	生れ合わせる
うまれ落ちる	うまれおちる
うまれ落ちる	生まれ落ちる
うまれ落ちる	生れ落ちる
うみ付ける	うみつける
うみ付ける	生み付ける
うみ分ける	うみわける
うみ分ける	生み分ける
うみ疲れる	うみつかれる
うみ疲れる	倦み疲れる
うめ合せる	うめあわせる
うめ合せる	埋め合せる
うめ合わせる	うめあわせる
うめ合わせる	埋め合わせる
うめ立てる	うめたてる
うめ立てる	埋め立てる
うら付ける	うらづける
うら付ける	裏付ける
うり上げる	うりあげる
うり上げる	売り上げる
うり上げる	売上げる
うり下げる	うりさげる
うり下げる	売り下げる
うり下げる	売下げる
うり付ける	うりつける
うり付ける	売り付ける
うり切れる	うりきれる
うり切れる	売り切れる
うり切れる	売切れる
うり広げる	うりひろげる
うり広げる	売り広げる
うり抜ける	うりぬける
うり抜ける	売り抜ける
うり抜ける	売抜ける
うわ向ける	うわむける
うわ向ける	上向ける
うんめい付ける	うんめいづける
うんめい付ける	運命付ける
えみ崩れる	えみくずれる
えみ崩れる	笑み崩れる
えり分ける	えりわける
えり分ける	よりわける
えり分ける	選り分ける
えん付ける	えんづける
えん付ける	縁付ける
おい上げる	おいあげる
おい上げる	追い上げる
おい上げる	追上げる
おい入れる	おいいれる
おい入れる	追い入れる
おい掛ける	おいかける
おい掛ける	追い掛ける
おい掛ける	追掛ける
おい果てる	おいはてる
おい果てる	老い果てる
おい果てる	老果てる
おい求める	おいもとめる
おい求める	追い求める
おい求める	追求める
おい立てる	おいたてる
おい立てる	追い立てる
おい立てる	追立てる
おい詰める	おいつめる
おい詰める	追い詰める
おい詰める	追詰める
おい退ける	おいのける
おい退ける	追い退ける
おおい被せる	おおいかぶせる
おおい被せる	覆い被せる
おおせ付ける	おおせつける
おおせ付ける	仰せつける
おおせ付ける	仰せ付ける
おおせ聞ける	おおせきける
おおせ聞ける	仰せ聞ける
おき忘れる	おきわすれる
おき忘れる	置き忘れる
おき忘れる	置忘れる
おき捨てる	おきすてる
おき捨てる	置き捨てる
おき捨てる	置捨てる
おき換える	おきかえる
おき換える	置き換える
おき換える	置換える
おき替える	おきかえる
おき替える	置き替える
おき替える	置替える
おくり付ける	おくりつける
おくり付ける	送り付ける
おくり届ける	おくりとどける
おくり届ける	送り届ける
おこり付ける	おこりつける
おこり付ける	怒り付ける
おさえ付ける	おさえつける
おさえ付ける	押さえ付ける
おしえ育てる	おしえそだてる
おしえ育てる	教え育てる
おしこらえる	おしこらえる
おしこらえる	押しこらえる
おし上げる	おしあげる
おし上げる	押し上げる
おし上げる	押上げる
おし下げる	おしさげる
おし下げる	押し下げる
おし下げる	押下げる
おし並べる	おしならべる
おし並べる	押し並べる
おし付ける	おしつける
おし付ける	押し付ける
おし伏せる	おしふせる
おし伏せる	押し伏せる
おし伏せる	押伏せる
おし入れる	おしいれる
おし入れる	押し入れる
おし入れる	押入れる
おし分ける	おしわける
おし分ける	押し分ける
おし分ける	押分ける
おし向ける	おしむける
おし向ける	押し向ける
おし向ける	押向ける
おし寄せる	おしよせる
おし寄せる	押し寄せる
おし寄せる	押寄せる
おし広げる	おしひろげる
おし広げる	押し広げる
おし広げる	押広げる
おし広める	おしひろめる
おし広める	押し広める
おし広める	押広める
おし当てる	おしあてる
おし当てる	押し当てる
おし当てる	押当てる
おし当てる	推し当てる
おし当てる	推当てる
おし掛ける	おしかける
おし掛ける	押し掛ける
おし掛ける	押掛ける
おし曲げる	おしまげる
おし曲げる	押し曲げる
おし曲げる	押曲げる
おし止める	おしとめる
おし止める	押し止める
おし沈める	おししずめる
おし沈める	押し沈める
おし沈める	押沈める
おし立てる	おしたてる
おし立てる	押し立てる
おし立てる	押立てる
おし詰める	おしつめる
おし詰める	押し詰める
おし詰める	押詰める
おし込める	おしこめる
おし込める	押し込める
おし込める	押込める
おし退ける	おしのける
おし退ける	押し退ける
おし進める	おしすすめる
おし進める	押し進める
おし進める	押進める
おし進める	推し進める
おし進める	推進める
おし鎮める	おししずめる
おし鎮める	押し鎮める
おし鎮める	押鎮める
おし開ける	おしあける
おし開ける	押し開ける
おし開ける	押開ける
おだてあげる	おだてあげる
おだてあげる	おだて上げる
おだて上げる	おだてあげる
おだて上げる	おだて上げる
おちこぼれる	おちこぼれる
おちこぼれる	落ちこぼれる
おち付ける	おちつける
おち付ける	落ち付ける
おち居る	おちいる
おち居る	落ち居る
おち延びる	おちのびる
おち延びる	落ち延びる
おち延びる	落延びる
おち着ける	おちつける
おち着ける	落ち着ける
おち着ける	落着ける
おっ付ける	おっつける
おっ付ける	押っ付ける
おっ伏せる	おっぷせる
おっ伏せる	押っ伏せる
おっ掛ける	おっかける
おっ掛ける	ぼっかける
おっ掛ける	追っ掛ける
おっ被せる	おっかぶせる
おっ被せる	押っ被せる
おとし入れる	おとしいれる
おとし入れる	落し入れる
おとし入れる	落とし入れる
おどし付ける	おどしつける
おどし付ける	脅しつける
おどし付ける	脅し付ける
おどり出る	おどりでる
おどり出る	躍り出る
おどろき呆れる	おどろきあきれる
おどろき呆れる	驚き呆れる
おびき入れる	おびきいれる
おびき入れる	おびき入れる
おびき入れる	誘き入れる
おびき寄せる	おびきよせる
おびき寄せる	誘き寄せる
おもい乱れる	おもいみだれる
おもい乱れる	思い乱れる
おもい倦ねる	おもいあぐねる
おもい倦ねる	思い倦ねる
おもい僻める	おもいひがめる
おもい僻める	思い僻める
おもい合せる	おもいあわせる
おもい合せる	思い合せる
おもい合わせる	おもいあわせる
おもい合わせる	思い合わせる
おもい定める	おもいさだめる
おもい定める	思い定める
おもい染める	おもいしめる
おもい染める	思い染める
おもい比べる	おもいくらべる
おもい比べる	思い比べる
おもい浮かべる	おもいうかべる
おもい浮かべる	思い浮かべる
おもい浮べる	おもいうかべる
おもい浮べる	思い浮べる
おもい焦がれる	おもいこがれる
おもい焦がれる	思い焦がれる
おもい知らせる	おもいしらせる
おもい知らせる	思い知らせる
おもい続ける	おもいつづける
おもい続ける	思い続ける
おもい見る	おもいみる
おもい見る	思い見る
おもい設ける	おもいもうける
おもい設ける	思い設ける
おもい詰める	おもいつめる
おもい詰める	思い詰める
おもい違える	おもいちがえる
おもい違える	思い違える
おもい頽れる	おもいくずれる
おもい頽れる	思い頽れる
およぎ出る	およぎでる
およぎ出る	泳ぎ出る
おり上げる	おりあげる
おり上げる	折り上げる
おり上げる	織り上げる
おり交ぜる	おりまぜる
おり交ぜる	織り交ぜる
おり交ぜる	織交ぜる
おり曲げる	おりまげる
おり曲げる	折り曲げる
おり曲げる	折曲げる
おり重ねる	おりかさねる
おり重ねる	折り重ねる
おり重ねる	折重ねる
おん出る	おんでる
おん出る	おん出る
おん出る	追ん出る
かい上げる	かいあげる
かい上げる	買い上げる
かい上げる	買上げる
かい与える	かいあたえる
かい与える	買い与える
かい与える	買与える
かい付ける	かいつける
かい付ける	買い付ける
かい入れる	かいいれる
かい入れる	買い入れる
かい入れる	買入れる
かい占める	かいしめる
かい占める	買い占める
かい占める	買占める
かい受ける	かいうける
かい受ける	買い受ける
かい受ける	買受ける
かい控える	かいひかえる
かい控える	かいびかえる
かい控える	買い控える
かい揃える	かいそろえる
かい揃える	買い揃える
かい換える	かいかえる
かい換える	買い換える
かい換える	買換える
かい整える	かいととのえる
かい整える	買い整える
かい整える	買整える
かい替える	かいかえる
かい替える	買い替える
かい替える	買替える
かい求める	かいもとめる
かい求める	買い求める
かい求める	買求める
かい立てる	かいたてる
かい立てる	買い立てる
かい立てる	買立てる
かい調える	かいととのえる
かい調える	買い調える
かい負ける	かいまける
かい負ける	買い負ける
かい負ける	買負ける
かい集める	かいあつめる
かい集める	買い集める
かい集める	買集める
かかえ上げる	かかえあげる
かかえ上げる	抱え上げる
かかえ下りる	かかえおりる
かかえ下りる	抱え下りる
かかえ入れる	かかえいれる
かかえ入れる	抱え入れる
かがやき出る	かがやきでる
かがやき出る	輝き出る
かきま見る	かきまみる
かきま見る	垣間見る
かきま違える	かきまちがえる
かきま違える	書間違える
かき上げる	かきあげる
かき上げる	掻き上げる
かき上げる	搔き上げる
かき上げる	書き上げる
かき上げる	書上げる
かき上げる	舁き上げる
かき並べる	かきならべる
かき並べる	書き並べる
かき乱れる	かきみだれる
かき乱れる	掻き乱れる
かき乱れる	搔き乱れる
かき付ける	かきつける
かき付ける	書き付ける
かき伝える	かきつたえる
かき伝える	書き伝える
かき伝える	書伝える
かき入れる	かきいれる
かき入れる	掻き入れる
かき入れる	搔き入れる
かき入れる	書き入れる
かき入れる	書入れる
かき入れる	舁き入れる
かき分ける	かきわける
かき分ける	掻き分ける
かき分ける	搔き分ける
かき分ける	書き分ける
かき分ける	書分ける
かき加える	かきくわえる
かき加える	書き加える
かき加える	書加える
かき合せる	かきあわせる
かき合せる	掻き合せる
かき合わせる	かきあわせる
かき合わせる	掻き合わせる
かき寄せる	かきよせる
かき寄せる	掻き寄せる
かき寄せる	搔き寄せる
かき忘れる	かきわすれる
かき忘れる	書忘れる
かき慣れる	かきなれる
かき慣れる	書き慣れる
かき慣れる	書慣れる
かき捨てる	かきすてる
かき捨てる	書き捨てる
かき捨てる	書捨てる
かき揚げる	かきあげる
かき揚げる	掻き揚げる
かき揚げる	搔き揚げる
かき換える	かきかえる
かき換える	書き換える
かき換える	書換える
かき損じる	かきそんじる
かき損じる	書き損じる
かき撫でる	かきなでる
かき撫でる	掻き撫でる
かき改める	かきあらためる
かき改める	書き改める
かき暗れる	かきくれる
かき暗れる	掻き暗れる
かき暮れる	かきくれる
かき暮れる	掻き暮れる
かき暮れる	搔き暮れる
かき替える	かきかえる
かき替える	書き替える
かき替える	書替える
かき果せる	かきおおせる
かき果せる	書き果せる
かき消える	かききえる
かき消える	掻き消える
かき消える	搔き消える
かき混ぜる	かきまぜる
かき混ぜる	掻き混ぜる
かき混ぜる	搔き混ぜる
かき添える	かきそえる
かき添える	書き添える
かき添える	書添える
かき溜める	かきためる
かき溜める	書き溜める
かき留める	かきとめる
かき留める	書き留める
かき留める	書留める
かき立てる	かきたてる
かき立てる	掻き立てる
かき立てる	搔き立てる
かき立てる	書き立てる
かき立てる	書立てる
かき納める	かきおさめる
かき納める	書き納める
かき納める	書納める
かき続ける	かきつづける
かき続ける	書き続ける
かき認める	かきしたためる
かき認める	書き認める
かき退ける	かきのける
かき退ける	掻き退ける
かき退ける	搔き退ける
かき連ねる	かきつらねる
かき連ねる	書き連ねる
かき連ねる	書連ねる
かき進める	かきすすめる
かき進める	書き進める
かき集める	かきあつめる
かき集める	掻き集める
かき集める	搔き集める
かき集める	書き集める
かき集める	書集める
かき雑ぜる	かきまぜる
かき雑ぜる	掻き雑ぜる
かき馴れる	かきなれる
かき馴れる	書き馴れる
かぎ付ける	かぎつける
かぎ付ける	嗅ぎ付ける
かぎ分ける	かぎわける
かぎ分ける	嗅ぎ分ける
かぎ当てる	かぎあてる
かぎ当てる	嗅ぎ当てる
かけ下りる	かけおりる
かけ下りる	駆け下りる
かけ付ける	かけつける
かけ付ける	駆け付ける
かけ合せる	かけあわせる
かけ合せる	掛け合せる
かけ合わせる	かけあわせる
かけ合わせる	掛け合わせる
かけ合わせる	掛合わせる
かけ抜ける	かけぬける
かけ抜ける	駆け抜ける
かけ抜ける	駆抜ける
かけ抜ける	駈け抜ける
かけ替える	かけかえる
かけ替える	掛け替える
かけ替える	掛替える
かけ比べる	かけくらべる
かけ比べる	駆け比べる
かけ着ける	かけつける
かけ着ける	駈け着ける
かけ連ねる	かけつらねる
かけ連ねる	掛け連ねる
かけ違える	かけちがえる
かけ違える	掛け違える
かけ降りる	かけおりる
かけ降りる	駆け降りる
かけ降りる	駆降りる
かけ降りる	駈け降りる
かけ離れる	かけはなれる
かけ離れる	かけ離れる
かけ離れる	懸け離れる
かけ離れる	懸離れる
かけ離れる	掛け離れる
かけ離れる	掛離れる
かこい入れる	かこいいれる
かこい入れる	囲い入れる
かさね上げる	かさねあげる
かさね上げる	重ね上げる
かざり付ける	かざりつける
かざり付ける	飾り付ける
かざり立てる	かざりたてる
かざり立てる	飾り立てる
かし下げる	かしさげる
かし下げる	貸し下げる
かし下げる	貸下げる
かし与える	かしあたえる
かし与える	貸し与える
かし与える	貸与える
かし付ける	かしつける
かし付ける	貸し付ける
かぞえ上げる	かぞえあげる
かぞえ上げる	数え上げる
かぞえ入れる	かぞえいれる
かぞえ入れる	数え入れる
かぞえ立てる	かぞえたてる
かぞえ立てる	数え立てる
かため上げる	かためあげる
かため上げる	固め上げる
かたり伝える	かたりつたえる
かたり伝える	語り伝える
かたり掛ける	かたりかける
かたり掛ける	語り掛ける
かたり聞かせる	かたりきかせる
かたり聞かせる	語り聞かせる
かた付ける	かたづける
かた付ける	片付ける
かた寄せる	かたよせる
かた寄せる	片寄せる
かち上げる	かちあげる
かち上げる	搗ち上げる
かち付ける	かちづける
かち付ける	価値付ける
かち得る	かちえる
かち得る	勝ち得る
かち得る	勝得る
かち得る	贏ち得る
かち過ぎる	かちすぎる
かち過ぎる	勝ち過ぎる
かち過ぎる	勝過ぎる
かつぎ上げる	かつぎあげる
かつぎ上げる	担ぎ上げる
かつぎ入れる	かつぎいれる
かつぎ入れる	担ぎ入れる
かね備える	かねそなえる
かね備える	兼ね備える
かね備える	兼備える
かまい付ける	かまいつける
かまい付ける	構い付ける
かみ交ぜる	かみまぜる
かみ交ぜる	嚙み交ぜる
かみ分ける	かみわける
かみ分ける	噛み分ける
かみ分ける	嚙み分ける
かみ合せる	かみあわせる
かみ合せる	噛み合せる
かみ合わせる	かみあわせる
かみ合わせる	噛み合わせる
かみ締める	かみしめる
かみ締める	噛み締める
かみ締める	嚙み締める
かよい詰める	かよいつめる
かよい詰める	通い詰める
からみ付ける	からみつける
からみ付ける	絡み付ける
かり上げる	かりあげる
かり上げる	借り上げる
かり上げる	借上げる
かり上げる	刈り上げる
かり上げる	刈上げる
かり入れる	かりいれる
かり入れる	借り入れる
かり入れる	借入れる
かり入れる	刈り入れる
かり入れる	刈入れる
かり受ける	かりうける
かり受ける	借り受ける
かり受ける	借受ける
かり換える	かりかえる
かり換える	借り換える
かり換える	借換える
かり立てる	かりたてる
かり立てる	駆り立てる
かり立てる	駆立てる
かり集める	かりあつめる
かり集める	駆り集める
かり集める	駆集める
かれ果てる	かれはてる
かれ果てる	枯れ果てる
かれ落ちる	かれおちる
かれ落ちる	枯れ落ちる
かわり果てる	かわりはてる
かわり果てる	変り果てる
かわり果てる	変わり果てる
かんがえ合せる	かんがえあわせる
かんがえ合せる	考え合せる
かんがえ合わせる	かんがえあわせる
かんがえ合わせる	考え合わせる
かんけい付ける	かんけいづける
かんけい付ける	関係付ける
かんれん付ける	かんれんづける
かんれん付ける	関連付ける
きえ失せる	きえうせる
きえ失せる	消え失せる
きえ果てる	きえはてる
きえ果てる	消え果てる
きき付ける	ききつける
きき付ける	聞き付ける
きき伝える	ききつたえる
きき伝える	聞き伝える
きき伝える	聞伝える
きき入れる	ききいれる
きき入れる	聞き入れる
きき入れる	聞入れる
きき分ける	ききわける
きき分ける	聞き分ける
きき分ける	聞分ける
きき占める	ききしめる
きき占める	聞き占める
きき合せる	ききあわせる
きき合せる	聞き合せる
きき合わせる	ききあわせる
きき合わせる	聞き合わせる
きき合わせる	聞合わせる
きき咎める	ききとがめる
きき咎める	聞き咎める
きき定める	ききさだめる
きき定める	聞き定める
きき定める	聞定める
きき届ける	ききとどける
きき届ける	聞き届ける
きき届ける	聞届ける
きき忘れる	ききわすれる
きき忘れる	聞き忘れる
きき忘れる	聞忘れる
きき惚れる	ききほれる
きき惚れる	聞き惚れる
きき惚れる	聴き惚れる
きき慣れる	ききなれる
きき慣れる	聞き慣れる
きき慣れる	聞慣れる
きき捨てる	ききすてる
きき捨てる	聞き捨てる
きき捨てる	聞捨てる
きき果てる	ききはてる
きき果てる	聞果てる
きき比べる	ききくらべる
きき比べる	聞き比べる
きき留める	ききとめる
きき留める	聞き留める
きき留める	聞留める
きき蕩れる	ききとれる
きき蕩れる	聞き蕩れる
きき覚える	ききおぼえる
きき覚える	聞き覚える
きき覚える	聞覚える
きき違える	ききちがえる
きき違える	聞き違える
きき違える	聞違える
きき飽きる	ききあきる
きき飽きる	聞き飽きる
きき馴れる	ききなれる
きき馴れる	聞き馴れる
きざみ上げる	きざみあげる
きざみ上げる	刻み上げる
きざみ付ける	きざみつける
きざみ付ける	刻み付ける
きざみ入れる	きざみいれる
きざみ入れる	刻み入れる
きせ付ける	きせつける
きせ付ける	着せ付ける
きせ掛ける	きせかける
きせ掛ける	着せ掛ける
きせ替える	きせかえる
きせ替える	着せ替える
きそ付ける	きそづける
きそ付ける	基礎付ける
きたえ上げる	きたえあげる
きたえ上げる	鍛え上げる
きっ掛ける	きっかける
きっ掛ける	切っ掛ける
きめ付ける	きめつける
きめ付ける	決め付ける
きり上げる	きりあげる
きり上げる	切り上げる
きり上げる	切上げる
きり下げる	きりさげる
きり下げる	切り下げる
きり下げる	切下げる
きり付ける	きりつける
きり付ける	切り付ける
きり伏せる	きりふせる
きり伏せる	切り伏せる
きり伏せる	切伏せる
きり伏せる	斬り伏せる
きり伏せる	斬伏せる
きり分ける	きりわける
きり分ける	切り分ける
きり分ける	切分ける
きり広げる	きりひろげる
きり広げる	切り広げる
きり広げる	切広げる
きり抜ける	きりぬける
きり抜ける	切り抜ける
きり抜ける	切抜ける
きり捨てる	きりすてる
きり捨てる	切り捨てる
きり捨てる	切捨てる
きり捨てる	斬り捨てる
きり捨てる	斬捨てる
きり掛ける	きりかける
きり掛ける	切り掛ける
きり掛ける	切掛ける
きり掛ける	斬り掛ける
きり掛ける	斬掛ける
きり揃える	きりそろえる
きり揃える	きろそろえる
きり揃える	切り揃える
きり換える	きりかえる
きり換える	切り換える
きり換える	切換える
きり替える	きりかえる
きり替える	切り替える
きり替える	切替える
きり立てる	きりたてる
きり立てる	切り立てる
きり立てる	切立てる
きり詰める	きりつめる
きり詰める	切り詰める
きり詰める	切詰める
きれ落ちる	きれおちる
きれ落ちる	切れ落ちる
き付ける	きつける
き付ける	着付ける
き合わせる	きあわせる
き合わせる	来合わせる
き崩れる	きくずれる
き崩れる	着崩れる
き慣れる	きなれる
き慣れる	来慣れる
き慣れる	着慣れる
き捨てる	きすてる
き捨てる	着捨てる
き換える	きかえる
き換える	着換える
き替える	きかえる
き替える	きがえる
き替える	着替える
き棄てる	きすてる
き棄てる	着棄てる
き脹れる	きぶくれる
き脹れる	着脹れる
き膨れる	きぶくれる
き膨れる	着膨れる
き馴れる	きなれる
き馴れる	着馴れる
ぎむ付ける	ぎむづける
ぎむ付ける	義務付ける
くいっ逸れる	くいっぱぐれる
くいっ逸れる	食いっ逸れる
くい兼ねる	くいかねる
くい兼ねる	食い兼ねる
くい厭きる	くいあきる
くい厭きる	食い厭きる
くい合せる	くいあわせる
くい合せる	食い合せる
くい合わせる	くいあわせる
くい合わせる	食い合わせる
くい合わせる	食合わせる
くい掛ける	くいかける
くい掛ける	食い掛ける
くい掛ける	食掛ける
くい止める	くいとめる
くい止める	食い止める
くい締める	くいしめる
くい締める	食い締める
くい締める	食締める
くい詰める	くいつめる
くい詰める	食い詰める
くい詰める	食詰める
くい逸れる	くいはぐれる
くい逸れる	食い逸れる
くい過ぎる	くいすぎる
くい過ぎる	食い過ぎる
くい過ぎる	食過ぎる
くい飽きる	くいあきる
くい飽きる	食い飽きる
くくし上げる	くくしあげる
くくし上げる	括し上げる
くくり上げる	くくりあげる
くくり上げる	括り上げる
くくり付ける	くくりつける
くくり付ける	括り付ける
くぐり抜ける	くぐりぬける
くぐり抜ける	くぐり抜ける
くぐり抜ける	潜り抜ける
くずれ落ちる	くずれおちる
くずれ落ちる	崩れ落ちる
くち付ける	くちづける
くち付ける	口付ける
くち慣れる	くちなれる
くち慣れる	口慣れる
くち果てる	くちはてる
くち果てる	朽ち果てる
くち果てる	朽果てる
くち衰える	くちおとろえる
くち衰える	朽ち衰える
くどき立てる	くどきたてる
くどき立てる	口説き立てる
くみ上げる	くみあげる
くみ上げる	汲み上げる
くみ上げる	組み上げる
くみ上げる	組上げる
くみ伏せる	くみふせる
くみ伏せる	組み伏せる
くみ伏せる	組伏せる
くみ入れる	くみいれる
くみ入れる	汲み入れる
くみ入れる	組み入れる
くみ入れる	組入れる
くみ分ける	くみわける
くみ分ける	汲み分ける
くみ分ける	組み分ける
くみ分ける	酌み分ける
くみ分ける	酌分ける
くみ合せる	くみあわせる
くみ合せる	組み合せる
くみ合わせる	くみあわせる
くみ合わせる	組み合わせる
くみ合わせる	組合わせる
くみ換える	くみかえる
くみ換える	組み換える
くみ換える	組換える
くみ替える	くみかえる
くみ替える	組み替える
くみ替える	組替える
くみ留める	くみとめる
くみ留める	組留める
くみ立てる	くみたてる
くみ立てる	組み立てる
くみ立てる	組立てる
くみ違える	くみちがえる
くみ違える	組み違える
くみ違える	組違える
くらべ合わせる	くらべあわせる
くらべ合わせる	比べ合わせる
くり上げる	くりあげる
くり上げる	繰り上げる
くり上げる	繰上げる
くり下げる	くりさげる
くり下げる	繰り下げる
くり下げる	繰下げる
くり入れる	くりいれる
くり入れる	繰り入れる
くり入れる	繰入れる
くり合せる	くりあわせる
くり合せる	繰り合せる
くり合わせる	くりあわせる
くり合わせる	繰り合わせる
くり合わせる	繰合わせる
くり寄せる	くりよせる
くり寄せる	繰り寄せる
くり寄せる	繰寄せる
くり広げる	くりひろげる
くり広げる	繰り広げる
くり広げる	繰広げる
くり延べる	くりのべる
くり延べる	繰り延べる
くり替える	くりかえる
くり替える	繰り替える
くり替える	繰替える
くれ果てる	くれはてる
くれ果てる	暮れ果てる
くれ落ちる	くれおちる
くれ落ちる	暮れ落ちる
くわえ入れる	くわえいれる
くわえ入れる	加え入れる
けご見る	けごみる
けご見る	警固見る
けし止める	けしとめる
けし止める	消し止める
けってい付ける	けっていづける
けってい付ける	決定付ける
けつろん付ける	けつろんづける
けつろん付ける	結論付ける
けなしつける	けなしつける
けなし付ける	けなしつける
けり上げる	けりあげる
けり上げる	蹴り上げる
けり付ける	けりつける
けり付ける	蹴り付ける
けり入れる	けりいれる
けり入れる	蹴り入れる
け上げる	けあげる
け上げる	蹴上げる
け立てる	けたてる
け立てる	蹴立てる
け退ける	けのける
け退ける	蹴退ける
け違える	けちがえる
け違える	蹴違える
げんき付ける	げんきづける
げんき付ける	元気付ける
こい初める	こいそめる
こい初める	恋い初める
こい初める	恋初める
こい受ける	こいうける
こい受ける	乞い受ける
こい受ける	請い受ける
こい焦がれる	こいこがれる
こい焦がれる	恋い焦がれる
こい焦がれる	恋焦がれる
こうじ果てる	こうじはてる
こうじ果てる	困じ果てる
こおり詰める	こおりつめる
こおり詰める	凍り詰める
こき混ぜる	こきまぜる
こき混ぜる	扱き混ぜる
こぎ入れる	こぎいれる
こぎ入れる	漕ぎ入れる
こぎ出る	こぎでる
こぎ出る	漕ぎ出る
こぎ回る	こぎみる
こぎ回る	漕ぎ回る
こぎ寄せる	こぎよせる
こぎ寄せる	漕ぎ寄せる
こぎ抜ける	こぎぬける
こぎ抜ける	漕ぎ抜ける
こぎ着ける	こぎつける
こぎ着ける	漕ぎ着ける
こころ付ける	こころづける
こころ付ける	心付ける
こころ得る	こころえる
こころ得る	心得る
こごえ果てる	こごえはてる
こごえ果てる	凍え果てる
こし掛ける	こしかける
こし掛ける	腰掛ける
こじつける	こじつける
こじつける	こじ付ける
こじ付ける	こじつける
こじ付ける	こじ付ける
こじ入れる	こじいれる
こじ入れる	抉じ入れる
こじ開ける	こじあける
こじ開ける	抉じ開ける
こすりいれる	こすりいれる
こすりいれる	こすり入れる
こすり上げる	こすりあげる
こすり上げる	こすり上げる
こすり上げる	擦り上げる
こすり付ける	こすりつける
こすり付ける	こすり付ける
こすり入れる	こすりいれる
こすり入れる	こすり入れる
こと付ける	ことづける
こと付ける	言付ける
こと切れる	こときれる
こと切れる	事切れる
こと寄せる	ことよせる
こと寄せる	事寄せる
こと寄せる	言寄せる
こと足りる	ことたりる
こと足りる	事足りる
こね上げる	こねあげる
こね上げる	捏ね上げる
こね合せる	こねあわせる
こね合せる	捏ね合せる
こね合わせる	こねあわせる
こね合わせる	捏ね合わせる
こぼれでる	こぼれでる
こぼれでる	こぼれ出る
こぼれ出る	こぼれでる
こぼれ出る	こぼれ出る
こぼれ落ちる	こぼれおちる
こぼれ落ちる	こぼれ落ちる
こぼれ落ちる	零れ落ちる
こまり果てる	こまりはてる
こまり果てる	困り果てる
こみ上げる	こみあげる
こみ上げる	込み上げる
こみ上げる	込上げる
ころがり出る	ころがりだす
ころがり出る	転がり出る
ころがり落ちる	ころがりおちる
ころがり落ちる	転がり落ちる
ころげ出る	ころげでる
ころげ出る	転げ出る
ころげ落ちる	ころげおちる
ころげ落ちる	転げ落ちる
さがし当てる	さがしあてる
さがし当てる	捜し当てる
さがし当てる	探し当てる
さがし求める	さがしもとめる
さがし求める	捜し求める
さがし求める	探し求める
さき乱れる	さきみだれる
さき乱れる	咲き乱れる
さき乱れる	咲乱れる
さき出る	さきでる
さき出る	咲き出る
さき初める	さきそめる
さき初める	咲き初める
さき初める	咲初める
さき溢れる	さきこぼれる
さき溢れる	咲き溢れる
さき遅れる	さきおくれる
さき遅れる	咲遅れる
さき零れる	さきこぼれる
さき零れる	咲き零れる
さぐり当てる	さぐりあてる
さぐり当てる	探り当てる
ささやき掛ける	ささやきかける
ささやき掛ける	囁き掛ける
さし上げる	さしあげる
さし上げる	差し上げる
さし上げる	差上げる
さし付ける	さしつける
さし付ける	差し付ける
さし伸べる	さしのべる
さし伸べる	差し伸べる
さし入れる	さしいれる
さし入れる	差し入れる
さし入れる	差入れる
さし出る	さしでる
さし出る	差し出る
さし出る	差出る
さし加える	さしくわえる
さし加える	差し加える
さし加える	差加える
さし向ける	さしむける
さし向ける	差し向ける
さし向ける	差向ける
さし固める	さしかためる
さし固める	差し固める
さし固める	差固める
さし固める	鎖し固める
さし延べる	さしのべる
さし延べる	差し延べる
さし当てる	さしあてる
さし当てる	差し当てる
さし当てる	差当てる
さし押える	さしおさえる
さし押える	差し押える
さし押さえる	さしおさえる
さし押さえる	差し押さえる
さし押さえる	差押さえる
さし掛ける	さしかける
さし掛ける	差し掛ける
さし掛ける	差掛ける
さし掛ける	指し掛ける
さし掛ける	指掛ける
さし控える	さしひかえる
さし控える	差し控える
さし控える	差控える
さし換える	さしかえる
さし換える	差し換える
さし換える	差換える
さし支える	さしつかえる
さし支える	差し支える
さし支える	差支える
さし替える	さしかえる
さし替える	差し替える
さし替える	差替える
さし止める	さしとめる
さし止める	刺し止める
さし止める	差し止める
さし添える	さしそえる
さし添える	差し添える
さし添える	差添える
さし立てる	さしたてる
さし立てる	差し立てる
さし立てる	差立てる
さし籠める	さしこめる
さし籠める	鎖し籠める
さし縺れる	さしもつれる
さし縺れる	差し縺れる
さし越える	さしこえる
さし越える	差し越える
さし越える	差越える
さし違える	さしちがえる
さし違える	刺し違える
さし違える	刺違える
さし違える	差し違える
さし違える	差違える
さすりあげる	さすりあげる
さすりあげる	さすり上げる
さすり上げる	さすりあげる
さすり上げる	さすり上げる
さそい入れる	さそいいれる
さそい入れる	誘い入れる
さそい合せる	さそいあわせる
さそい合せる	誘い合せる
さそい合わせる	さそいあわせる
さそい合わせる	誘い合わせる
さそい掛ける	さそいかける
さそい掛ける	誘い掛ける
さまよいでる	さまよいでる
さまよいでる	さまよい出る
さまよい出る	さまよいでる
さまよい出る	さまよい出る
さらいあげる	さらいあげる
さらいあげる	さらい上げる
さらい上げる	さらいあげる
さらい上げる	さらい上げる
さわぎ立てる	さわぎたてる
さわぎ立てる	騒ぎ立てる
しえる	つかえる
しえる	仕える
しかり付ける	しかりつける
しかり付ける	叱り付ける
しき詰める	しきつめる
しき詰める	敷き詰める
しき詰める	敷詰める
しごきあげる	しごきあげる
しごきあげる	しごき上げる
しごき上げる	しごきあげる
しごき上げる	しごき上げる
したたり落ちる	したたりおちる
したたり落ちる	したたり落ちる
したたり落ちる	滴り落ちる
したて上げる	したてあげる
したて上げる	仕立て上げる
しに切れる	しにきれる
しに切れる	死に切れる
しに別れる	しにわかれる
しに別れる	死に別れる
しに後れる	しにおくれる
しに後れる	死に後れる
しに懸ける	しにかける
しに懸ける	死に懸ける
しに掛ける	しにかける
しに掛ける	死に掛ける
しに果てる	しにはてる
しに果てる	死に果てる
しに絶える	しにたえる
しに絶える	死に絶える
しに遅れる	しにおくれる
しに遅れる	死に遅れる
しのび出る	しのびでる
しのび出る	忍び出る
しばり上げる	しばりあげる
しばり上げる	縛り上げる
しばり付ける	しばりつける
しばり付ける	縛り付ける
しば見る	しばみる
しば見る	屡見る
しば見る	屢見る
しぼり上げる	しぼりあげる
しぼり上げる	搾り上げる
しぼり上げる	絞り上げる
しぼり入れる	しぼりいれる
しぼり入れる	絞り入れる
しまい忘れる	しまいわすれる
しまい忘れる	蔵い忘れる
しみ付ける	しみつける
しみ付ける	染み付ける
しみ出る	しみでる
しみ出る	染み出る
しみ出る	染出る
しめし与える	しめしあたえる
しめし与える	示し与える
しめし合せる	しめしあわせる
しめし合せる	示し合せる
しめし合わせる	しめしあわせる
しめし合わせる	示し合わせる
しめ上げる	しめあげる
しめ上げる	締め上げる
しめ上げる	締上げる
しめ付ける	しめつける
しめ付ける	締めつける
しめ付ける	締め付ける
しめ寄せる	しめよせる
しめ寄せる	締め寄せる
しめ寄せる	締寄せる
しゃくり上げる	しゃくりあげる
しゃくり上げる	噦り上げる
しゃべりかける	しゃべりかける
しゃべりかける	しゃべり掛ける
しゃべり掛ける	しゃべりかける
しゃべり掛ける	しゃべり掛ける
しゃべり立てる	しゃべりたてる
しゃべり立てる	しゃべり立てる
しゃべり立てる	喋り立てる
しょうじ入れる	しょうじいれる
しょうじ入れる	招じ入れる
しょうじ入れる	請じ入れる
しょく過ぎる	しょくすぎる
しょく過ぎる	職過ぎる
しらべ上げる	しらべあげる
しらべ上げる	調べ上げる
しり初める	しりそめる
しり初める	知初める
し上げる	しあげる
し上げる	仕上げる
し付ける	しつける
し付ける	仕付ける
し入れる	しいれる
し入れる	仕入れる
し兼ねる	しかねる
し兼ねる	仕兼ねる
し分ける	しわける
し分ける	仕分ける
し向ける	しむける
し向ける	仕向ける
し慣れる	しなれる
し慣れる	為慣れる
し掛ける	しかける
し掛ける	仕掛ける
し損じる	しそんじる
し損じる	仕損じる
し替える	しかえる
し替える	仕替える
し果てる	しはてる
し果てる	為果てる
し留める	しとめる
し留める	仕留める
し留める	為留める
し立てる	したてる
し立てる	仕立てる
し立て上げる	したてあげる
し立て上げる	仕立て上げる
し舞ひ付ける	しまいつける
し舞ひ付ける	仕舞ひ付ける
し訳ける	しわける
し訳ける	仕訳ける
し遂げる	しとげる
し遂げる	仕遂げる
し遂げる	為遂げる
し違える	しちがえる
し違える	為違える
すい上げる	すいあげる
すい上げる	吸い上げる
すい上げる	吸上げる
すい付ける	すいつける
すい付ける	吸い付ける
すい入れる	すいいれる
すい入れる	吸い入れる
すい入れる	吸入れる
すい寄せる	すいよせる
すい寄せる	吸い寄せる
すい寄せる	吸寄せる
すえ付ける	すえつける
すえ付ける	据え付ける
すかし見る	すかしみる
すかし見る	透かし見る
すくい上げる	すくいあげる
すくい上げる	掬いあげる
すくい上げる	掬い上げる
すくい上げる	救い上げる
すくい入れる	すくいいれる
すくい入れる	掬い入れる
すげ替える	すげかえる
すげ替える	すげ替える
すげ替える	挿げ替える
すげ替える	箝げ替える
すすみ出る	すすみでる
すすみ出る	進み出る
すすり上げる	すすりあげる
すすり上げる	すすり上げる
すすり上げる	啜り上げる
すべり出る	すべりでる
すべり出る	滑り出る
すべり落ちる	すべりおちる
すべり落ちる	滑り落ちる
すべり降りる	すべりおりる
すべり降りる	滑り降りる
すみ侘びる	すみわびる
すみ侘びる	住み侘びる
すみ分ける	すみわける
すみ分ける	棲み分ける
すみ慣れる	すみなれる
すみ慣れる	住み慣れる
すみ慣れる	住慣れる
すみ替える	すみかえる
すみ替える	住み替える
すみ替える	住替える
すみ馴れる	すみなれる
すみ馴れる	住み馴れる
すり上げる	こすりあげる
すり上げる	すりあげる
すり上げる	刷り上げる
すり上げる	刷上げる
すり上げる	擦り上げる
すり付ける	すりつける
すり付ける	なすりつける
すり付ける	摺り付ける
すり付ける	擦り付ける
すり入れる	すりいれる
すり入れる	摺り入れる
すり切れる	すりきれる
すり切れる	摩り切れる
すり切れる	摺り切れる
すり切れる	擦り切れる
すり切れる	擦切れる
すり剝ける	すりむける
すり剝ける	擦り剝ける
すり合せる	すりあわせる
すり合せる	摺り合せる
すり合せる	擦り合せる
すり合わせる	すりあわせる
すり合わせる	摺り合わせる
すり抜ける	すりぬける
すり抜ける	擦り抜ける
すり抜ける	擦抜ける
すり替える	すりかえる
すり替える	すり替える
すり替える	掏り替える
ずりあげる	ずりあげる
ずりあげる	ずり上げる
ずりおりる	ずりおりる
ずりおりる	ずり下りる
ずりでる	ずりでる
ずりでる	ずり出る
ずり上げる	ずりあげる
ずり上げる	ずり上げる
ずり下りる	ずりおりる
ずり下りる	ずり下りる
ずり出る	ずりでる
ずり出る	ずり出る
ず抜ける	ずぬける
ず抜ける	図抜ける
ず抜ける	頭抜ける
せき上げる	せきあげる
せき上げる	咳き上げる
せき上げる	堰き上げる
せき上げる	塞き上げる
せき上げる	急き上げる
せき立てる	せきたてる
せき立てる	急き立てる
せめ付ける	せめつける
せめ付ける	攻め付ける
せめ付ける	責めつける
せめ付ける	責め付ける
せめ寄せる	せめよせる
せめ寄せる	攻め寄せる
せめ寄せる	攻寄せる
せめ掛ける	せめかける
せめ掛ける	攻め掛ける
せめ掛ける	攻掛ける
せめ掛ける	責掛ける
せめ立てる	せめたてる
せめ立てる	攻め立てる
せめ立てる	攻立てる
せめ立てる	責め立てる
せめ立てる	責立てる
せり上げる	せりあげる
せり上げる	競り上げる
せり上げる	競上げる
せり上げる	迫り上げる
せり立てる	せりたてる
せり立てる	迫り立てる
せり詰める	せりつめる
せり詰める	迫り詰める
せり負ける	せりまける
せり負ける	競り負ける
せり負ける	競負ける
せんじ詰める	せんじつめる
せんじ詰める	煎じ詰める
そい遂げる	そいとげる
そい遂げる	添い遂げる
そい遂げる	添遂げる
そげ落ちる	そげおちる
そげ落ちる	削げ落ちる
そそぎ入れる	そそぎいれる
そそぎ入れる	注ぎ入れる
そそぎ掛ける	そそぎかける
そそぎ掛ける	注ぎ掛ける
そだて上げる	そだてあげる
そだて上げる	育て上げる
そなえ付ける	そなえつける
そなえ付ける	備え付ける
そめ上げる	そめあげる
そめ上げる	染め上げる
そめ上げる	染上げる
そめ付ける	そめつける
そめ付ける	染め付ける
そめ分ける	そめわける
そめ分ける	染め分ける
そめ分ける	染分ける
そめ変える	そめかえる
そめ変える	染め変える
そめ替える	そめかえる
そめ替える	染め替える
そめ替える	染替える
そり上げる	そりあげる
そり上げる	剃り上げる
そり下げる	そりさげる
そり下げる	剃り下げる
ぞんじ上げる	ぞんじあげる
ぞんじ上げる	存じ上げる
たえ果てる	たえはてる
たえ果てる	絶え果てる
たえ果てる	絶果てる
たき上げる	たきあげる
たき上げる	炊き上げる
たき付ける	たきつける
たき付ける	焚き付ける
たき染める	たきしめる
たき染める	焚き染める
たき染める	薫き染める
たき込める	たきこめる
たき込める	薫き込める
たぎりおちる	たぎりおちる
たぎりおちる	たぎり落ちる
たぎり落ちる	たぎりおちる
たぎり落ちる	たぎり落ちる
たくしいれる	たくしいれる
たくしいれる	たくし入れる
たくし入れる	たくしいれる
たくし入れる	たくし入れる
たくりあげる	たくりあげる
たくりあげる	たくり上げる
たくり上げる	たくりあげる
たくり上げる	たくり上げる
たぐりいれる	たぐりいれる
たぐりいれる	たぐり入れる
たぐり上げる	たぐりあげる
たぐり上げる	たぐり上げる
たぐり上げる	手繰り上げる
たぐり上げる	手繰上げる
たぐり入れる	たぐりいれる
たぐり入れる	たぐり入れる
たぐり寄せる	たぐりよせる
たぐり寄せる	手繰り寄せる
たぐり寄せる	手繰寄せる
たし合わせる	たしあわせる
たし合わせる	足し合わせる
たすけ上げる	たすけあげる
たすけ上げる	助け上げる
たずね合せる	たずねあわせる
たずね合せる	尋ね合せる
たずね合わせる	たずねあわせる
たずね合わせる	尋ね合わせる
たずね当てる	たずねあてる
たずね当てる	尋ね当てる
たずね掛ける	たずねかける
たずね掛ける	尋ね掛ける
たたき上げる	たたきあげる
たたき上げる	叩き上げる
たたき付ける	たたきつける
たたき付ける	叩き付ける
たたき伏せる	たたきふせる
たたき伏せる	叩き伏せる
たたき入れる	たたきいれる
たたき入れる	叩き入れる
たたき立てる	たたきたてる
たたき立てる	叩き立てる
たたみ上げる	たたみあげる
たたみ上げる	畳み上げる
たたみ掛ける	たたみかける
たたみ掛ける	畳み掛ける
ただよい出る	ただよいでる
ただよい出る	漂い出る
たち上げる	たちあげる
たち上げる	立ち上げる
たち上げる	立上げる
たち切れる	たちきれる
たち切れる	立ち切れる
たち別れる	たちわかれる
たち別れる	立ち別れる
たち別れる	立別れる
たち合わせる	たちあわせる
たち合わせる	裁ち合わせる
たち合わせる	裁合わせる
たち居る	たちいる
たち居る	立ち居る
たち後れる	たちおくれる
たち後れる	立ち後れる
たち枯れる	たちがれる
たち枯れる	立ち枯れる
たち籠める	たちこめる
たち籠める	立ち籠める
たち籠める	立籠める
たち続ける	たちつづける
たち続ける	立ち続ける
たち草臥れる	たちくたびれる
たち草臥れる	立ち草臥れる
たち見る	たちみる
たち見る	立ち見る
たち越える	たちこえる
たち越える	立ち越える
たち越える	立越える
たち込める	たちこめる
たち込める	立ち込める
たち遅れる	たちおくれる
たち遅れる	立ち遅れる
たち遅れる	立遅れる
たち顕れる	たちあらわれる
たち顕れる	立ち顕れる
たて付ける	たてつける
たて付ける	建て付ける
たて付ける	立て付ける
たて懸ける	たてかける
たて懸ける	立て懸ける
たて掛ける	たてかける
たて掛ける	立て掛ける
たて掛ける	立掛ける
たて替える	たてかえる
たて替える	建て替える
たて替える	建替える
たて替える	立て替える
たて替える	立替える
たて籠める	たてこめる
たて籠める	立て籠める
たて込める	たてこめる
たて込める	立て込める
たて込める	立込める
たて込める	閉て込める
たび慣れる	たびなれる
たび慣れる	旅慣れる
たべ付ける	たべつける
たべ付ける	食べ付ける
たべ分ける	たべわける
たべ分ける	食べ分ける
たべ慣れる	たべなれる
たべ慣れる	食べ慣れる
たべ掛ける	たべかける
たべ掛ける	食べ掛ける
たべ比べる	たべくらべる
たべ比べる	食べ比べる
たべ過ぎる	たべすぎる
たべ過ぎる	食べ過ぎる
たれ籠める	たれこめる
たれ籠める	垂れ籠める
たれ込める	たれこめる
たれ込める	垂れ込める
た向ける	たむける
た向ける	手向ける
だき上げる	だきあげる
だき上げる	抱き上げる
だき上げる	抱上げる
だき入れる	だきいれる
だき入れる	抱入れる
だき合せる	だきあわせる
だき合せる	抱き合せる
だき合わせる	だきあわせる
だき合わせる	抱き合わせる
だき合わせる	抱合わせる
だき寄せる	だきよせる
だき寄せる	抱き寄せる
だき寄せる	抱寄せる
だき抱える	だきかかえる
だき抱える	抱き抱える
だき止める	だきとめる
だき止める	抱き止める
だき留める	だきとめる
だき留める	抱き留める
だき留める	抱留める
だき竦める	だきすくめる
だき竦める	抱き竦める
だき締める	だきしめる
だき締める	抱き締める
だき締める	抱締める
だし遅れる	だしおくれる
だし遅れる	出し遅れる
ちから付ける	ちからづける
ちから付ける	力付ける
ちか付ける	ちかづける
ちか付ける	近付ける
ちか寄せる	ちかよせる
ちか寄せる	近寄せる
ちぎれおちる	ちぎれおちる
ちぎれおちる	ちぎれ落ちる
ちぎれ落ちる	ちぎれおちる
ちぎれ落ちる	ちぎれ落ちる
ちょうじ合わせる	ちょうじあわせる
ちょうじ合わせる	諜じ合わせる
ちり乱れる	ちりみだれる
ちり乱れる	散り乱れる
ちり乱れる	散乱れる
ちり初める	ちりそめる
ちり初める	散初める
ちり落ちる	ちりおちる
ちり落ちる	散り落ちる
つかい付ける	つかいつける
つかい付ける	使い付ける
つかい分ける	つかいわける
つかい分ける	使い分ける
つかい慣れる	つかいなれる
つかい慣れる	使い慣れる
つかい捨てる	つかいすてる
つかい捨てる	使い捨てる
つかい馴れる	つかいなれる
つかい馴れる	使い馴れる
つかみ上げる	つかみあげる
つかみ上げる	掴み上げる
つかみ入れる	つかみいれる
つかみ入れる	掴み入れる
つかれ果てる	つかれはてる
つかれ果てる	疲れ果てる
つき上げる	つきあげる
つき上げる	突き上げる
つき上げる	突上げる
つき上げる	築き上げる
つき上げる	衝き上げる
つき交ぜる	つきまぜる
つき交ぜる	搗き交ぜる
つき交ぜる	舂き交ぜる
つき付ける	つきつける
つき付ける	突き付ける
つき入れる	つきいれる
つき入れる	突き入れる
つき入れる	突入れる
つき出る	つきでる
つき出る	突き出る
つき出る	突出る
つき合せる	つきあわせる
つき合せる	突き合せる
つき合わせる	つきあわせる
つき合わせる	突き合わせる
つき合わせる	突合わせる
つき固める	つきかためる
つき固める	突き固める
つき固める	突固める
つき当てる	つきあてる
つき当てる	突き当てる
つき当てる	突当てる
つき抜ける	つきぬける
つき抜ける	突き抜ける
つき抜ける	突抜ける
つき据える	つきすえる
つき据える	突き据える
つき据える	突据える
つき掛ける	つきかける
つき掛ける	突き掛ける
つき掛ける	突掛ける
つき果てる	つきはてる
つき果てる	尽き果てる
つき果てる	尽果てる
つき止める	つきとめる
つき止める	突き止める
つき立てる	つきたてる
つき立てる	突き立てる
つき立てる	突立てる
つき立てる	築き立てる
つき詰める	つきつめる
つき詰める	突き詰める
つき詰める	突詰める
つき退ける	つきのける
つき退ける	突き退ける
つき開ける	つきあける
つき開ける	突き開ける
つき除ける	つきのける
つき除ける	突き除ける
つぎ合せる	つぎあわせる
つぎ合せる	継ぎ合せる
つぎ合わせる	つぎあわせる
つぎ合わせる	継ぎ合わせる
つぎ合わせる	継合わせる
つぎ立てる	つぎたてる
つぎ立てる	継ぎ立てる
つぎ立てる	継立てる
つくり上げる	つくりあげる
つくり上げる	作り上げる
つくり付ける	つくりつける
つくり付ける	作り付ける
つくり合せる	つくりあわせる
つくり合せる	作り合せる
つくり合わせる	つくりあわせる
つくり合わせる	作り合わせる
つくり替える	つくりかえる
つくり替える	作り替える
つくり立てる	つくりたてる
つくり立てる	作り立てる
つくり立てる	造り立てる
つけ加える	つけくわえる
つけ加える	付け加える
つけ加える	付加える
つけ合せる	つけあわせる
つけ合せる	付け合せる
つけ合わせる	つけあわせる
つけ合わせる	付け合わせる
つけ合わせる	付合わせる
つけ替える	つけかえる
つけ替える	付け替える
つけ替える	付替える
つけ添える	つけそえる
つけ添える	付け添える
つけ添える	付添える
つたい落ちる	つたいおちる
つたい落ちる	伝い落ちる
つたえ受ける	つたえうける
つたえ受ける	伝え受ける
つたわり落ちる	つたわりおちる
つたわり落ちる	伝わり落ちる
つっ包める	つっくるめる
つっ包める	突っ包める
つっ含める	つっくるめる
つっ含める	突っ含める
つっ括める	つっくるめる
つっ括める	突っ括める
つっ掛ける	つっかける
つっ掛ける	突っ掛ける
つっ撥ねる	つっぱねる
つっ撥ねる	突っ撥ねる
つっ立てる	つったてる
つっ立てる	突っ立てる
つっ跳ねる	つっぱねる
つっ跳ねる	突っぱねる
つづり合わせる	つづりあわせる
つづり合わせる	綴り合わせる
つとめ上げる	つとめあげる
つとめ上げる	勤め上げる
つなぎ合わせる	つなぎあわせる
つなぎ合わせる	繋ぎ合わせる
つなぎ止める	つなぎとめる
つなぎ止める	繋ぎ止める
つねりあげる	つねりあげる
つねり上げる	つねりあげる
つまみあげる	つまみあげる
つまみあげる	つまみ上げる
つまみいれる	つまみいれる
つまみいれる	つまみ入れる
つまみ上げる	つまみあげる
つまみ上げる	つまみ上げる
つまみ入れる	つまみいれる
つまみ入れる	つまみ入れる
つみ上げる	つみあげる
つみ上げる	積み上げる
つみ上げる	積上げる
つみ入れる	つみいれる
つみ入れる	積み入れる
つみ換える	つみかえる
つみ換える	積み換える
つみ換える	積換える
つみ替える	つみかえる
つみ替える	積み替える
つみ替える	積替える
つみ立てる	つみたてる
つみ立てる	積み立てる
つみ立てる	積立てる
つみ重ねる	つみかさねる
つみ重ねる	積み重ねる
つみ重ねる	積重ねる
つめ合せる	つめあわせる
つめ合せる	詰め合せる
つめ合わせる	つめあわせる
つめ合わせる	詰め合わせる
つめ合わせる	詰合わせる
つめ寄せる	つめよせる
つめ寄せる	詰め寄せる
つめ寄せる	詰寄せる
つめ掛ける	つめかける
つめ掛ける	詰め掛ける
つめ掛ける	詰掛ける
つめ替える	つめかえる
つめ替える	詰め替える
つめ替える	詰替える
つり上げる	つりあげる
つり上げる	吊り上げる
つり上げる	釣り上げる
つり上げる	釣上げる
つり下げる	つりさげる
つり下げる	吊り下げる
つり下げる	釣り下げる
つり下げる	釣下げる
つるし上げる	つるしあげる
つるし上げる	吊るし上げる
つるべ掛ける	つるべかける
つるべ掛ける	連べ掛ける
つるべ掛ける	釣瓶掛ける
てらし付ける	てらしつける
てらし付ける	照らし付ける
てらし合せる	てらしあわせる
てらし合せる	照らし合せる
てらし合わせる	てらしあわせる
てらし合わせる	照らし合わせる
てり付ける	てりつける
てり付ける	照り付ける
てり合せる	てりあわせる
てり合せる	照り合せる
てり合わせる	てりあわせる
てり合わせる	照り合わせる
てり合わせる	照合わせる
てり映える	てりはえる
てり映える	照り映える
て慣れる	てなれる
て慣れる	手慣れる
でき過ぎる	できすぎる
でき過ぎる	出来過ぎる
でし遅れる	だしおくれる
でし遅れる	出し遅れる
でっち上げる	でっちあげる
でっち上げる	捏ち上げる
でっ会せる	でっくわせる
でっ会せる	出っ会せる
でで居る	いでいる
でで居る	出で居る
で外れる	ではずれる
で外れる	出外れる
で抜ける	でぬける
で抜ける	出抜ける
で掛ける	でかける
で掛ける	出掛ける
で来る	でける
で来る	出来る
で来過ぎる	できすぎる
で来過ぎる	出来過ぎる
で迎える	でむかえる
で迎える	出迎える
で遅れる	でおくれる
で遅れる	出遅れる
で過ぎる	ですぎる
で過ぎる	出過ぎる
で離れる	ではなれる
で離れる	出離れる
とい合せる	といあわせる
とい合せる	問い合せる
とい合わせる	といあわせる
とい合わせる	問い合わせる
とい合わせる	問合わせる
とい掛ける	といかける
とい掛ける	問い掛ける
とい掛ける	問掛ける
とい詰める	といつめる
とい詰める	問い詰める
とい詰める	問詰める
とおり合せる	とおりあわせる
とおり合せる	通り合せる
とおり合わせる	とおりあわせる
とおり合わせる	通り合わせる
とおり抜ける	とおりぬける
とおり抜ける	通り抜ける
とおり過ぎる	とおりすぎる
とおり過ぎる	通り過ぎる
とお退ける	とおのける
とお退ける	遠退ける
とかし入れる	とかしいれる
とかし入れる	溶かし入れる
とがめたてる	とがめたてる
とがめたてる	とがめ立てる
とがめ立てる	とがめたてる
とがめ立てる	とがめ立てる
とき付ける	ときつける
とき付ける	説き付ける
とき伏せる	ときふせる
とき伏せる	説き伏せる
とき伏せる	説伏せる
とき入れる	ときいれる
とき入れる	溶き入れる
とき分ける	ときわける
とき分ける	説き分ける
とき分ける	説分ける
とき勧める	ときすすめる
とき勧める	説き勧める
とき立てる	ときたてる
とき立てる	説き立てる
とき聞かせる	とききかせる
とき聞かせる	説き聞かせる
とき聞かせる	説聞かせる
とぎ上げる	とぎあげる
とぎ上げる	研ぎ上げる
とぎ上げる	研上げる
とくしょく付ける	とくしょくづける
とくしょく付ける	特色付ける
とくちょう付ける	とくちょうづける
とくちょう付ける	特徴付ける
とけ出る	とけでる
とけ出る	溶け出る
とじ付ける	とじつける
とじ付ける	綴じ付ける
とじ合せる	とじあわせる
とじ合せる	綴じ合せる
とじ合わせる	とじあわせる
とじ合わせる	綴じ合わせる
とじ込める	とじこめる
とじ込める	閉じ込める
とじ込める	閉込める
とっ替える	とっかえる
とっ替える	取っ替える
とどけ出る	とどけでる
とどけ出る	届け出る
とどけ出る	届出る
とび下りる	とびおりる
とび下りる	飛び下りる
とび下りる	飛下りる
とび出る	とびでる
とび出る	飛び出る
とび出る	飛出る
とび抜ける	とびぬける
とび抜ける	飛び抜ける
とび抜ける	飛抜ける
とび起きる	とびおきる
とび起きる	飛び起きる
とび起きる	飛起きる
とび越える	とびこえる
とび越える	跳び越える
とび越える	跳越える
とび越える	飛び越える
とび越える	飛越える
とび跳ねる	とびはねる
とび跳ねる	飛び跳ねる
とび跳ねる	飛跳ねる
とび降りる	とびおりる
とび降りる	飛び降りる
とび降りる	飛降りる
とび離れる	とびはなれる
とび離れる	飛び離れる
とび離れる	飛離れる
とまり合わせる	とまりあわせる
とまり合わせる	泊まり合わせる
とめ付ける	とめつける
とめ付ける	留め付ける
とりかた付ける	とりかたづける
とりかた付ける	取り片付ける
とりかた付ける	取片付ける
とり上げる	とりあげる
とり上げる	取り上げる
とり上げる	取上げる
とり上げる	撮り上げる
とり上せる	とりのぼせる
とり上せる	取り上せる
とり下げる	とりさげる
とり下げる	取り下げる
とり下げる	取下げる
とり並べる	とりならべる
とり並べる	取り並べる
とり乱れる	とりみだれる
とり乱れる	取り乱れる
とり乱れる	取乱れる
とり交ぜる	とりまぜる
とり交ぜる	取り交ぜる
とり交ぜる	取交ぜる
とり付ける	とりつける
とり付ける	取り付ける
とり入れる	とりいれる
とり入れる	取り入れる
とり入れる	取入れる
とり分ける	とりわける
とり分ける	取り分ける
とり分ける	取分ける
とり収める	とりおさめる
とり収める	取り収める
とり合せる	とりあわせる
とり合せる	取り合せる
とり合わせる	とりあわせる
とり合わせる	取り合わせる
とり合わせる	取合わせる
とり固める	とりかためる
とり固める	取り固める
とり固める	取固める
とり寄せる	とりよせる
とり寄せる	取り寄せる
とり寄せる	取寄せる
とり広げる	とりひろげる
とり広げる	取り広げる
とり広げる	取広げる
とり忘れる	とりわすれる
とり忘れる	取忘れる
とり憑かれる	とりつかれる
とり憑かれる	取り憑かれる
とり抑える	とりおさえる
とり抑える	取り抑える
とり押える	とりおさえる
とり押える	取り押える
とり押さえる	とりおさえる
とり押さえる	取り押さえる
とり押さえる	取押さえる
とり捨てる	とりすてる
とり捨てる	取り捨てる
とり捨てる	取捨てる
とり掛ける	とりかける
とり掛ける	取掛ける
とり揃える	とりそろえる
とり揃える	取り揃える
とり換える	とりかえる
とり換える	取り換える
とり換える	取換える
とり替える	とりかえる
とり替える	取り替える
とり替える	取替える
とり極める	とりきめる
とり極める	取り極める
とり止める	とりやめる
とり止める	取り止める
とり決める	とりきめる
とり決める	取り決める
とり決める	取決める
とり混ぜる	とりまぜる
とり混ぜる	取り混ぜる
とり混ぜる	取混ぜる
とり添える	とりそえる
とり添える	取り添える
とり添える	取添える
とり片付ける	とりかたづける
とり片付ける	取り片付ける
とり片付ける	取片付ける
とり率る	とりいる
とり率る	取り率る
とり留める	とりとめる
とり留める	取り留める
とり留める	取留める
とり立てる	とりたてる
とり立てる	取り立てる
とり立てる	取立てる
とり籠める	とりこめる
とり籠める	取り籠める
とり籠める	取籠める
とり納める	とりおさめる
とり納める	取り納める
とり納める	取納める
とり紛れる	とりまぎれる
とり紛れる	取り紛れる
とり紛れる	取紛れる
とり纏める	とりまとめる
とり纏める	取り纏める
とり見る	とりみる
とり見る	取り見る
とり見る	執り見る
とり詰める	とりつめる
とり詰める	取り詰める
とり詰める	取詰める
とり調べる	とりしらべる
とり調べる	取り調べる
とり調べる	取調べる
とり逆上る	とりのぼせる
とり逆上る	取り逆上る
とり違える	とりちがえる
とり違える	取り違える
とり違える	取違える
とり鎮める	とりしずめる
とり鎮める	取り鎮める
とり鎮める	取鎮める
とり除ける	とりのける
とり除ける	取り除ける
とり集める	とりあつめる
とり集める	取り集める
とり集める	取集める
どなり上げる	どなりあげる
どなり上げる	怒鳴り上げる
どなり付ける	どなりつける
どなり付ける	怒鳴り付ける
どなり立てる	どなりたてる
どなり立てる	怒鳴り立てる
どやしつける	どやしつける
どやし付ける	どやしつける
ない交ぜる	ないまぜる
ない交ぜる	綯い交ぜる
ながし入れる	ながしいれる
ながし入れる	流し入れる
ながれ出る	ながれでる
ながれ出る	流れ出る
ながれ落ちる	ながれおちる
ながれ落ちる	流れ落ちる
なき別れる	なきわかれる
なき別れる	泣き別れる
なき別れる	泣別れる
なき崩れる	なきくずれる
なき崩れる	泣き崩れる
なき崩れる	泣崩れる
なき濡れる	なきぬれる
なき濡れる	泣き濡れる
なき立てる	なきたてる
なき立てる	泣き立てる
なき立てる	泣立てる
なき立てる	鳴き立てる
なき立てる	鳴立てる
なぎ伏せる	なぎふせる
なぎ伏せる	薙ぎ伏せる
なぎ立てる	なぎたてる
なぎ立てる	薙ぎ立てる
なぐり付ける	なぐりつける
なぐり付ける	殴りつける
なぐり付ける	殴り付ける
なげ上げる	なげあげる
なげ上げる	投げ上げる
なげ与える	なげあたえる
なげ与える	投げ与える
なげ付ける	なげつける
なげ付ける	投げ付ける
なげ入れる	なげいれる
なげ入れる	投げ入れる
なげ入れる	投入れる
なげ捨てる	なげすてる
なげ捨てる	投げ捨てる
なげ捨てる	投捨てる
なげ掛ける	なげかける
なげ掛ける	投げ掛ける
なげ掛ける	投掛ける
なげ棄てる	なげすてる
なげ棄てる	投げ棄てる
なし遂げる	なしとげる
なし遂げる	成し遂げる
なし遂げる	成遂げる
なし遂げる	為し遂げる
なだれ落ちる	なだれおちる
なだれ落ちる	なだれ落ちる
なだれ落ちる	傾れ落ちる
なだれ落ちる	雪崩落ちる
なで上げる	なであげる
なで上げる	撫で上げる
なで付ける	なでつける
なで付ける	撫でつける
なで付ける	撫で付ける
なのり出る	なのりでる
なのり出る	名乗り出る
ならい覚える	ならいおぼえる
ならい覚える	習い覚える
ならべ上げる	ならべあげる
ならべ上げる	並べ上げる
ならべ換える	ならべかえる
ならべ換える	並べ換える
ならべ替える	ならべかえる
ならべ替える	並べ替える
ならべ立てる	ならべたてる
ならべ立てる	並べ立てる
なり果せる	なりおおせる
なり果せる	成り果せる
なり果てる	なりはてる
なり果てる	成り果てる
なり果てる	成果てる
なれ初める	なれそめる
なれ初める	馴れ初める
な付ける	なづける
な付ける	名付ける
にえ零れる	にえこぼれる
にえ零れる	煮え零れる
にぎり締める	にぎりしめる
にぎり締める	握り締める
にぎり詰める	にぎりつめる
にぎり詰める	握り詰める
にげ出る	にげでる
にげ出る	逃げ出る
にげ失せる	にげうせる
にげ失せる	逃げ失せる
にげ延びる	にげのびる
にげ延びる	逃げ延びる
にげ延びる	逃延びる
にげ果せる	にげおおせる
にげ果せる	逃げ果せる
にげ落ちる	にげおちる
にげ落ちる	逃げ落ちる
にげ落ちる	逃落ちる
にげ遅れる	にげおくれる
にげ遅れる	逃げ遅れる
にげ遅れる	逃遅れる
にげ隠れる	にげかくれる
にげ隠れる	逃げ隠れる
にじみる	しみる
にじみる	滲みる
にじみ出る	にじみでる
にじみ出る	滲み出る
にじり出る	にじりでる
にじり出る	にじり出る
にじり出る	躙り出る
にらみあげる	にらみあげる
にらみあげる	にらみ上げる
にらみ上げる	にらみあげる
にらみ上げる	にらみ上げる
にらみ付ける	にらみつける
にらみ付ける	にらみ付ける
にらみ合わせる	にらみあわせる
にらみ合わせる	にらみ合わせる
にらみ合わせる	睨み合わせる
にらみ据える	にらみすえる
にらみ据える	睨み据える
に上げる	にあげる
に上げる	煮上げる
に付ける	につける
に付ける	煮付ける
に合せる	にあわせる
に合せる	煮合せる
に合わせる	にあわせる
に合わせる	煮合わせる
に含める	にふくめる
に含める	煮含める
に崩れる	にくずれる
に崩れる	煮崩れる
に染める	にしめる
に染める	煮染める
に立たせる	にたたせる
に立たせる	煮立たせる
に立てる	にたてる
に立てる	煮立てる
に詰める	につめる
に詰める	煮詰める
に零れる	にこぼれる
に零れる	煮零れる
ぬい上げる	ぬいあげる
ぬい上げる	縫い上げる
ぬい上げる	縫上げる
ぬい付ける	ぬいつける
ぬい付ける	縫い付ける
ぬい入れる	ぬいいれる
ぬい入れる	縫入れる
ぬい合せる	ぬいあわせる
ぬい合せる	縫い合せる
ぬい合わせる	ぬいあわせる
ぬい合わせる	縫い合わせる
ぬい合わせる	縫合わせる
ぬい込める	ぬいこめる
ぬい込める	縫い込める
ぬきん出る	ぬきんでる
ぬきん出る	抜きん出る
ぬき出る	ぬきでる
ぬき出る	ぬきんでる
ぬき出る	抜きん出る
ぬき出る	抜き出る
ぬき出る	抜出る
ぬき合せる	ぬきあわせる
ぬき合せる	抜き合せる
ぬき合わせる	ぬきあわせる
ぬき合わせる	抜き合わせる
ぬき合わせる	抜合わせる
ぬき連れる	ぬきつれる
ぬき連れる	抜き連れる
ぬき連れる	抜連れる
ぬぎ捨てる	ぬぎすてる
ぬぎ捨てる	脱ぎ捨てる
ぬぎ捨てる	脱捨てる
ぬぎ掛ける	ぬぎかける
ぬぎ掛ける	脱ぎ掛ける
ぬぎ掛ける	脱掛ける
ぬぎ換える	ぬぎかえる
ぬぎ換える	脱換える
ぬけ出る	ぬけでる
ぬけ出る	抜け出る
ぬけ出る	脱け出る
ぬけ落ちる	ぬけおちる
ぬけ落ちる	抜け落ちる
ぬげ落ちる	ぬげおちる
ぬげ落ちる	脱げ落ちる
ぬすみ見る	ぬすみみる
ぬすみ見る	盗み見る
ぬり上げる	ぬりあげる
ぬり上げる	塗り上げる
ぬり上げる	塗上げる
ぬり付ける	ぬりつける
ぬり付ける	塗り付ける
ぬり固める	ぬりかためる
ぬり固める	塗り固める
ぬり固める	塗固める
ぬり替える	ぬりかえる
ぬり替える	塗り替える
ぬり替える	塗替える
ぬり立てる	ぬりたてる
ぬり立てる	塗り立てる
ぬり立てる	塗立てる
ぬり籠める	ぬりこめる
ぬり籠める	塗り籠める
ぬり籠める	塗籠める
ぬり込める	ぬりこめる
ぬり込める	塗り込める
ぬり込める	塗込める
ねかし付ける	ねかしつける
ねかし付ける	寝かし付ける
ねがい上げる	ねがいあげる
ねがい上げる	願い上げる
ねがい下げる	ねがいさげる
ねがい下げる	願い下げる
ねがい出る	ねがいでる
ねがい出る	願い出る
ねじり上げる	ねじりあげる
ねじり上げる	ねじり上げる
ねじり上げる	捩じり上げる
ねじ上げる	ねじあげる
ねじ上げる	ねじ上げる
ねじ上げる	捩じ上げる
ねじ上げる	捻じ上げる
ねじ伏せる	ねじふせる
ねじ伏せる	ねじ伏せる
ねじ伏せる	捩じ伏せる
ねじ伏せる	捻じ伏せる
ねじ向ける	ねじむける
ねじ向ける	ねじ向ける
ねじ向ける	捩じ向ける
ねじ向ける	捻じ向ける
ねじ曲げる	ねじまげる
ねじ曲げる	ねじ曲げる
ねじ曲げる	捩じ曲げる
ねじ曲げる	捻じ曲げる
ねじ開ける	ねじあける
ねじ開ける	ねじ開ける
ねじ開ける	捩じ開ける
ねじ開ける	捻じ開ける
ねせ付ける	ねせつける
ねせ付ける	寝せ付ける
ねめ付ける	ねめつける
ねめ付ける	睨め付ける
ねらい定める	ねらいさだめる
ねらい定める	狙い定める
ねり上げる	ねりあげる
ねり上げる	煉り上げる
ねり上げる	練り上げる
ねり上げる	練上げる
ねり上げる	錬り上げる
ねり合せる	ねりあわせる
ねり合せる	練り合せる
ねり合わせる	ねりあわせる
ねり合わせる	煉り合わせる
ねり合わせる	練り合わせる
ねり合わせる	練合わせる
ねり固める	ねりかためる
ねり固める	煉り固める
ねり固める	練り固める
ねり固める	練固める
ね乱れる	ねみだれる
ね乱れる	寝乱れる
ね倒れる	ねたおれる
ね倒れる	寝倒れる
ね忘れる	ねわすれる
ね忘れる	寝忘れる
ね惚ける	ねぼける
ね惚ける	寝惚ける
ね惚れる	ねほれる
ね惚れる	寝惚れる
ね腐れる	ねくたれる
ね腐れる	寝腐れる
ね腫れる	ねはれる
ね腫れる	寝腫れる
ね覚める	ねざめる
ね覚める	寝覚める
ね過ぎる	ねすぎる
ね過ぎる	寝過ぎる
ね違える	ねちがえる
ね違える	寝違える
ね飽きる	ねあきる
ね飽きる	寝飽きる
のがれ出る	のがれでる
のがれ出る	逃れ出る
のさばりでる	のさばりでる
のさばりでる	のさばり出る
のさばり出る	のさばりでる
のさばり出る	のさばり出る
のし上げる	のしあげる
のし上げる	伸し上げる
のせ掛ける	のせかける
のせ掛ける	乗せ掛ける
のせ掛ける	載せ掛ける
のぞき見る	のぞきみる
のぞき見る	覗き見る
のぞみ見る	のぞみみる
のぞみ見る	望み見る
のべ立てる	のべたてる
のべ立てる	述べ立てる
のぼり詰める	のぼりつめる
のぼり詰める	上り詰める
のぼり詰める	登り詰める
のみ付ける	のみつける
のみ付ける	飲み付ける
のみ分ける	のみわける
のみ分ける	飲み分ける
のみ掛ける	のみかける
のみ掛ける	飲み掛ける
のみ掛ける	飲掛ける
のみ比べる	のみくらべる
のみ比べる	飲み比べる
のみ潰れる	のみつぶれる
のみ潰れる	吞み潰れる
のみ潰れる	飲み潰れる
のみ潰れる	飲潰れる
のり上げる	のりあげる
のり上げる	乗り上げる
のり上げる	乗上げる
のり付ける	のりつける
のり付ける	乗り付ける
のり入れる	のりいれる
のり入れる	乗り入れる
のり入れる	乗入れる
のり合せる	のりあわせる
のり合せる	乗り合せる
のり合わせる	のりあわせる
のり合わせる	乗り合わせる
のり合わせる	乗合わせる
のり慣れる	のりなれる
のり慣れる	乗り慣れる
のり慣れる	乗慣れる
のり捨てる	のりすてる
のり捨てる	乗り捨てる
のり捨てる	乗捨てる
のり掛ける	のりかける
のり掛ける	乗り掛ける
のり掛ける	乗掛ける
のり換える	のりかえる
のり換える	乗り換える
のり換える	乗換える
のり替える	のりかえる
のり替える	乗り替える
のり替える	乗替える
のり越える	のりこえる
のり越える	乗り越える
のり越える	乗越える
のり遅れる	のりおくれる
のり遅れる	乗り遅れる
のり遅れる	乗遅れる
のり静める	のりしずめる
のり静める	乗り静める
のり馴れる	のりなれる
のり馴れる	乗り馴れる
はい出る	はいでる
はい出る	這い出る
はい降りる	はいおりる
はい降りる	這い降りる
はえ出る	はえでる
はえ出る	生え出る
はきためる	はきためる
はきためる	掃きためる
はき付ける	はきつける
はき付ける	履きつける
はき入れる	はきいれる
はき入れる	掃き入れる
はき寄せる	はきよせる
はき寄せる	掃き寄せる
はき寄せる	掃寄せる
はき捨てる	はきすてる
はき捨てる	吐き捨てる
はき捨てる	吐捨てる
はき捨てる	履き捨てる
はき捨てる	履捨てる
はき捨てる	掃き捨てる
はき捨てる	掃捨てる
はき替える	はきかえる
はき替える	履き替える
はき替える	履替える
はき清める	はききよめる
はき清める	掃き清める
はき清める	掃清める
はき違える	はきちがえる
はき違える	履き違える
はき違える	履違える
はき違える	穿き違える
はき集める	はきあつめる
はき集める	掃き集める
はぎ合わせる	はぎあわせる
はぎ合わせる	接ぎ合わせる
はげ落ちる	はげおちる
はげ落ちる	剝げ落ちる
はげ落ちる	剥げ落ちる
はこび上げる	はこびあげる
はこび上げる	運び上げる
はこび入れる	はこびいれる
はこび入れる	運び入れる
はさみ上げる	はさみあげる
はさみ上げる	挟み上げる
はさみ付ける	はさみつける
はさみ付ける	挟み付ける
はさみ入れる	はさみいれる
はさみ入れる	挟み入れる
はしゃぎたてる	はしゃぎたてる
はしゃぎたてる	はしゃぎ立てる
はしゃぎ立てる	はしゃぎたてる
はしゃぎ立てる	はしゃぎ立てる
はしり出る	はしりでる
はしり出る	走り出る
はしり抜ける	はしりぬける
はしり抜ける	走り抜ける
はしり過ぎる	はしりすぎる
はしり過ぎる	走り過ぎる
はずれ落ちる	はずれおちる
はずれ落ちる	外れ落ちる
はせ参じる	はせさんじる
はせ参じる	馳せ参じる
はせ着ける	はせつける
はせ着ける	馳せ着ける
はたきつける	はたきつける
はたきつける	はたき付ける
はたき付ける	はたきつける
はたき付ける	はたき付ける
はたらき掛ける	はたらきかける
はたらき掛ける	働き掛ける
はなし掛ける	はなしかける
はなし掛ける	話しかける
はなし掛ける	話し掛ける
はなし疲れる	はなしつかれる
はなし疲れる	話し疲れる
はなれ落ちる	はなれおちる
はなれ落ちる	離れ落ちる
はね上げる	はねあげる
はね上げる	撥ね上げる
はね上げる	跳ね上げる
はね付ける	はねつける
はね付ける	撥ね付ける
はね掛ける	はねかける
はね掛ける	撥ね掛ける
はね起きる	はねおきる
はね起きる	跳ね起きる
はね除ける	はねのける
はね除ける	撥ね除ける
はみ出る	はみでる
はみ出る	はみ出る
はみ出る	食み出る
はめいれる	はめいれる
はめいれる	はめ入れる
はめ入れる	はめいれる
はめ入れる	はめ入れる
はやし立てる	はやしたてる
はやし立てる	はやし立てる
はやし立てる	囃し立てる
はらい上げる	はらいあげる
はらい上げる	払い上げる
はらい下げる	はらいさげる
はらい下げる	払い下げる
はらい下げる	払下げる
はらい清める	はらいきよめる
はらい清める	祓い清める
はらい除ける	はらいのける
はらい除ける	払い除ける
はり上げる	はりあげる
はり上げる	張り上げる
はり上げる	張上げる
はり付ける	はりつける
はり付ける	張り付ける
はり付ける	貼り付ける
はり切れる	はりきれる
はり切れる	張り切れる
はり切れる	張切れる
はり合せる	はりあわせる
はり合せる	張り合せる
はり合せる	貼り合せる
はり合わせる	はりあわせる
はり合わせる	張り合わせる
はり合わせる	貼り合わせる
はり替える	はりかえる
はり替える	張り替える
はり替える	張替える
はり替える	貼り替える
はり替える	貼替える
はり裂ける	はりさける
はり裂ける	張り裂ける
はり裂ける	張裂ける
はり詰める	はりつめる
はり詰める	張り詰める
はり詰める	張詰める
ば慣れる	ばなれる
ば慣れる	場慣れる
ひきずり上げる	ひきずりあげる
ひきずり上げる	引きずり上げる
ひきずり入れる	ひきずりいれる
ひきずり入れる	引きずり入れる
ひき上げる	ひきあげる
ひき上げる	引き上げる
ひき上げる	引上げる
ひき下げる	ひきさげる
ひき下げる	引き下げる
ひき下げる	引下げる
ひき付ける	ひきつける
ひき付ける	引き付ける
ひき入れる	ひきいれる
ひき入れる	引き入れる
ひき入れる	引入れる
ひき分ける	ひきわける
ひき分ける	引き分ける
ひき分ける	引分ける
ひき受ける	ひきうける
ひき受ける	引き受ける
ひき受ける	引受ける
ひき合せる	ひきあわせる
ひき合せる	引き合せる
ひき合わせる	ひきあわせる
ひき合わせる	引き合わせる
ひき合わせる	引合わせる
ひき寄せる	ひきよせる
ひき寄せる	引き寄せる
ひき寄せる	引寄せる
ひき当てる	ひきあてる
ひき当てる	引き当てる
ひき当てる	引当てる
ひき括める	ひきくるめる
ひき括める	引き括める
ひき据える	ひきすえる
ひき据える	引き据える
ひき据える	引据える
ひき掛ける	ひきかける
ひき掛ける	引き掛ける
ひき掛ける	引掛ける
ひき揃える	ひきそろえる
ひき揃える	引き揃える
ひき揚げる	ひきあげる
ひき揚げる	引き揚げる
ひき揚げる	引揚げる
ひき換える	ひきかえる
ひき換える	引き換える
ひき換える	引換える
ひき攣れる	ひきつれる
ひき攣れる	引き攣れる
ひき替える	ひきかえる
ひき替える	引き替える
ひき替える	引替える
ひき止める	ひきとめる
ひき止める	引き止める
ひき比べる	ひきくらべる
ひき比べる	引き比べる
ひき比べる	引比べる
ひき留める	ひきとめる
ひき留める	引き留める
ひき留める	引留める
ひき立てる	ひきたてる
ひき立てる	引き立てる
ひき立てる	引立てる
ひき締める	ひきしめる
ひき締める	引き締める
ひき締める	引締める
ひき詰める	ひきつめる
ひき詰める	引き詰める
ひき詰める	引詰める
ひき較べる	ひきくらべる
ひき較べる	引き較べる
ひき込める	ひきこめる
ひき込める	引き込める
ひき込める	引込める
ひき退ける	ひきのける
ひき退ける	引き退ける
ひき連れる	ひきつれる
ひき連れる	引き連れる
ひき連れる	引連れる
ひき違える	ひきちがえる
ひき違える	引き違える
ひき違える	引違える
ひき開ける	ひきあける
ひき開ける	引開ける
ひたし入れる	ひたしいれる
ひたし入れる	浸し入れる
ひっぱり上げる	ひっぱりあげる
ひっぱり上げる	引っ張り上げる
ひっぱり下げる	ひっさげる
ひっぱり下げる	引っ下げる
ひっぱり付ける	ひっつける
ひっぱり付ける	引っ付ける
ひっぱり張り上げる	ひっぱりあげる
ひっぱり張り上げる	引っ張り上げる
ひっぱり張り入れる	ひっぱりいれる
ひっぱり張り入れる	引っ張り入れる
ひっぱり懸ける	ひっかける
ひっぱり懸ける	引っ懸ける
ひっぱり抱える	ひっかかえる
ひっぱり抱える	引っ抱える
ひっぱり括める	ひっくるめる
ひっぱり括める	引っ括める
ひっぱり捕える	ひっとらえる
ひっぱり捕える	引っ捕える
ひっぱり捕まえる	ひっつかまえる
ひっぱり捕まえる	引っ捕まえる
ひっぱり捕らえる	ひっとらえる
ひっぱり捕らえる	引っ捕らえる
ひっぱり掛ける	ひっかける
ひっぱり掛ける	引っ掛ける
ひっぱり掴まえる	ひっつかまえる
ひっぱり掴まえる	引っ掴まえる
ひっぱり提げる	ひっさげる
ひっぱり提げる	引っ提げる
ひっぱり立てる	ひったてる
ひっぱり立てる	引っ立てる
ひっぱり紮げる	ひっからげる
ひっぱり紮げる	引っ紮げる
ひっぱり絡げる	ひっからげる
ひっぱり絡げる	引っ絡げる
ひっぱり詰める	ひっつめる
ひっぱり詰める	引っ詰める
ひっぱり込める	ひっこめる
ひっぱり込める	引っ込める
ひっ下げる	ひっさげる
ひっ下げる	引っ下げる
ひっ付ける	ひっつける
ひっ付ける	引っ付ける
ひっ抱える	ひっかかえる
ひっ抱える	引っ抱える
ひっ掛ける	ひっかける
ひっ掛ける	引っ掛ける
ひっ立てる	ひったてる
ひっ立てる	引っ立てる
ひっ詰める	ひっつめる
ひっ詰める	引っ詰める
ひっ込める	ひっこめる
ひっ込める	引っ込める
ひと慣れる	ひとなれる
ひと慣れる	人慣れる
ひねりあげる	ひねりあげる
ひねりあげる	ひねり上げる
ひねりいれる	ひねりいれる
ひねりいれる	ひねり入れる
ひねり上げる	ひねりあげる
ひねり上げる	ひねり上げる
ひねり入れる	ひねりいれる
ひねり入れる	ひねり入れる
ひも付ける	ひもづける
ひも付ける	紐付ける
ひろい上げる	ひろいあげる
ひろい上げる	拾い上げる
ひろい集める	ひろいあつめる
ひろい集める	拾い集める
ふうじ込める	ふうじこめる
ふうじ込める	封じ込める
ふき上げる	ふきあげる
ふき上げる	吹き上げる
ふき上げる	吹上げる
ふき上げる	噴き上げる
ふき上げる	噴上げる
ふき付ける	ふきつける
ふき付ける	吹き付ける
ふき入れる	ふきいれる
ふき入れる	吹き入れる
ふき入れる	吹入れる
ふき出る	ふきでる
ふき出る	吹き出る
ふき出る	吹出る
ふき出る	噴き出る
ふき出る	噴出る
ふき分ける	ふきわける
ふき分ける	吹き分ける
ふき分ける	吹分ける
ふき寄せる	ふきよせる
ふき寄せる	吹き寄せる
ふき寄せる	吹寄せる
ふき抜ける	ふきぬける
ふき抜ける	吹き抜ける
ふき抜ける	吹抜ける
ふき掛ける	ふきかける
ふき掛ける	吹き掛ける
ふき掛ける	吹掛ける
ふき替える	ふきかえる
ふき替える	吹き替える
ふき替える	吹替える
ふき替える	葺き替える
ふき着ける	ふきつける
ふき着ける	吹着ける
ふき立てる	ふきたてる
ふき立てる	吹き立てる
ふき立てる	吹立てる
ふき立てる	拭き立てる
ふき荒れる	ふきあれる
ふき荒れる	吹き荒れる
ふき荒れる	吹荒れる
ふき集める	ふきあつめる
ふき集める	吹き集める
ふき集める	吹集める
ふき零れる	ふきこぼれる
ふき零れる	吹き零れる
ふっ切れる	ふっきれる
ふっ切れる	吹っ切れる
ふっ掛ける	ふっかける
ふっ掛ける	吹っ掛ける
ふみ付ける	ふみつける
ふみ付ける	踏み付ける
ふみ入れる	ふみいれる
ふみ入れる	踏み入れる
ふみ入れる	踏入れる
ふみ分ける	ふみわける
ふみ分ける	踏み分ける
ふみ分ける	踏分ける
ふみ固める	ふみかためる
ふみ固める	踏み固める
ふみ固める	踏固める
ふみ堪える	ふみこたえる
ふみ堪える	踏み堪える
ふみ換える	ふみかえる
ふみ換える	踏換える
ふみ替える	ふみかえる
ふみ替える	踏み替える
ふみ替える	踏替える
ふみ立てる	ふみたてる
ふみ立てる	踏み立てる
ふみ立てる	踏立てる
ふみ締める	ふみしめる
ふみ締める	踏み締める
ふみ締める	踏締める
ふみ越える	ふみこえる
ふみ越える	踏み越える
ふみ越える	踏越える
ふみ違える	ふみちがえる
ふみ違える	踏み違える
ふみ違える	踏違える
ふみ開ける	ふみはだける
ふみ開ける	踏み開ける
ふりさけ見る	ふりさけみる
ふりさけ見る	振り放け見る
ふりる	おりる
ふりる	降りる
ふり上げる	ふりあげる
ふり上げる	振り上げる
ふり上げる	振上げる
ふり付ける	ふりつける
ふり付ける	振り付ける
ふり入れる	ふりいれる
ふり入れる	振り入れる
ふり分ける	ふりわける
ふり分ける	振り分ける
ふり分ける	振分ける
ふり切れる	ふりきれる
ふり切れる	振り切れる
ふり向ける	ふりむける
ふり向ける	振り向ける
ふり向ける	振向ける
ふり当てる	ふりあてる
ふり当てる	振り当てる
ふり当てる	振当てる
ふり懸ける	ふりかける
ふり懸ける	振り懸ける
ふり捨てる	ふりすてる
ふり捨てる	振り捨てる
ふり捨てる	振捨てる
ふり掛ける	ふりかける
ふり掛ける	振り掛ける
ふり掛ける	振掛ける
ふり放け見る	ふりさけみる
ふり放け見る	振り放け見る
ふり替える	ふりかえる
ふり替える	振り替える
ふり替える	振替える
ふり立てる	ふりたてる
ふり立てる	振り立てる
ふり立てる	振立てる
ふり籠める	ふりこめる
ふり籠める	降り籠める
ふり籠める	降籠める
ふり落ちる	ふりおちる
ふり落ちる	降り落ちる
ふるい分ける	ふるいわける
ふるい分ける	篩い分ける
ふん付ける	ふんづける
ふん付ける	踏ん付ける
ふ切れる	ふっきれる
ふ切れる	吹っ切れる
ふ抜ける	ふぬける
ふ抜ける	腑抜ける
ぶち上げる	ぶちあげる
ぶち上げる	ぶち上げる
ぶち上げる	打ち上げる
ぶち上げる	打上げる
ぶち切れる	ぶちきれる
ぶち切れる	打ち切れる
ぶち明ける	ぶちあける
ぶち明ける	打ち明ける
ぶち開ける	ぶちあける
ぶち開ける	打ち開ける
ぶっ切れる	ぶっきれる
ぶっ切れる	打っ切れる
ぶっ掛ける	ぶっかける
ぶっ掛ける	ぶっ掛ける
ぶっ掛ける	打っ掛ける
ぶん投げる	ぶんなげる
ぶん投げる	打ん投げる
へし曲げる	へしまげる
へし曲げる	圧し曲げる
べんじ付ける	べんじつける
べんじ付ける	弁じ付ける
べんじ立てる	べんじたてる
べんじ立てる	弁じ立てる
ほうこう付ける	ほうこうづける
ほうこう付ける	方向付ける
ほうり上げる	ほうりあげる
ほうり上げる	放り上げる
ほうり付ける	ほうりつける
ほうり付ける	放り付ける
ほうり投げる	ほうりなげる
ほうり投げる	放り投げる
ほえ立てる	ほえたてる
ほえ立てる	吠え立てる
ほし上げる	ほしあげる
ほし上げる	乾し上げる
ほし上げる	干し上げる
ほし上げる	干上げる
ほし固める	ほしかためる
ほし固める	乾し固める
ほし固める	干し固める
ほし固める	干固める
ほとばしりでる	ほとばしりでる
ほとばしりでる	ほとばしり出る
ほとばしり出る	ほとばしりでる
ほとばしり出る	ほとばしり出る
ほほえみ掛ける	ほほえみかける
ほほえみ掛ける	微笑み掛ける
ほめ上げる	ほめあげる
ほめ上げる	褒め上げる
ほめ上げる	誉め上げる
ほめ称える	ほめたたえる
ほめ称える	褒め称える
ほめ称える	誉め称える
ほめ立てる	ほめたてる
ほめ立てる	褒め立てる
ほめ立てる	誉め立てる
ほり上げる	ほりあげる
ほり上げる	彫り上げる
ほり上げる	彫上げる
ほり下げる	ほりさげる
ほり下げる	掘り下げる
ほり下げる	掘下げる
ほり付ける	ほりつける
ほり付ける	彫り付ける
ほり入れる	ほりいれる
ほり入れる	彫り入れる
ほり入れる	掘り入れる
ほり当てる	ほりあてる
ほり当てる	掘り当てる
ほり当てる	掘当てる
ほり立てる	ほりたてる
ほり立てる	掘立てる
ぼっ掛ける	ぼっかける
ぼっ掛ける	追っ掛ける
ぼっ立てる	ぼったてる
ぼっ立てる	追っ立てる
まい上げる	まいあげる
まい上げる	舞い上げる
まい出る	まいでる
まい出る	舞い出る
まい納める	まいおさめる
まい納める	舞い納める
まい納める	舞納める
まい落ちる	まいおちる
まい落ちる	舞い落ちる
まい落ちる	舞落ちる
まい降りる	まいおりる
まい降りる	舞い降りる
まい降りる	舞降りる
まかり出る	まかりでる
まかり出る	まかり出る
まかり出る	罷り出る
まき上げる	まきあげる
まき上げる	巻き上げる
まき上げる	巻上げる
まき上げる	捲き上げる
まき付ける	まきつける
まき付ける	巻き付ける
まき入れる	まきいれる
まき入れる	巻き入れる
まき揚げる	まきあげる
まき揚げる	巻き揚げる
まき揚げる	巻揚げる
まき替える	まきかえる
まき替える	巻替える
まくし上げる	まくしあげる
まくし上げる	まくし上げる
まくし上げる	捲し上げる
まくし掛ける	まくしかける
まくし掛ける	捲し掛ける
まくし立てる	まくしたてる
まくし立てる	まくし立てる
まくし立てる	捲し立てる
まくりいれる	まくりいれる
まくりいれる	まくり入れる
まくり上げる	まくりあげる
まくり上げる	捲り上げる
まくり入れる	まくりいれる
まくり入れる	まくり入れる
まぜ入れる	まぜいれる
まぜ入れる	混ぜ入れる
まぜ合せる	まぜあわせる
まぜ合せる	混ぜ合せる
まぜ合わせる	まぜあわせる
まぜ合わせる	交ぜ合わせる
まぜ合わせる	混ぜ合わせる
まち付ける	まちつける
まち付ける	待ち付ける
まち伏せる	まちぶせる
まち伏せる	待ち伏せる
まち侘びる	まちわびる
まち侘びる	待ち侘びる
まち倦ねる	まちあぐねる
まち倦ねる	待ち倦ねる
まち兼ねる	まちかねる
まち兼ねる	待ち兼ねる
まち受ける	まちうける
まち受ける	待ち受ける
まち受ける	待受ける
まち合せる	まちあわせる
まち合せる	待ち合せる
まち合わせる	まちあわせる
まち合わせる	待ち合わせる
まち合わせる	待合わせる
まち構える	まちかまえる
まち構える	待ち構える
まち構える	待構える
まち焦がれる	まちこがれる
まち焦がれる	待ち焦がれる
まち焦がれる	待焦がれる
まち草臥れる	まちくたびれる
まち草臥れる	待ち草臥れる
まち設ける	まちもうける
まち設ける	待ち設ける
まつりつける	まつりつける
まつりつける	まつり付ける
まつり上げる	まつりあげる
まつり上げる	祭り上げる
まつり付ける	まつりつける
まつり付ける	まつり付ける
まとめ上げる	まとめあげる
まとめ上げる	まとめ上げる
まとめ上げる	纏め上げる
まに合わせる	まにあわせる
まに合わせる	間に合わせる
まねき入れる	まねきいれる
まねき入れる	招き入れる
まねき寄せる	まねきよせる
まねき寄せる	招き寄せる
まぶしつける	まぶしつける
まぶしつける	まぶし付ける
まぶし付ける	まぶしつける
まぶし付ける	まぶし付ける
まよい出る	まよいでる
まよい出る	迷い出る
まわし入れる	まわしいれる
まわし入れる	回し入れる
まわし掛ける	まわしかける
まわし掛ける	回し掛ける
ま違える	まちがえる
ま違える	間違える
みがき上げる	みがきあげる
みがき上げる	磨き上げる
みがき立てる	みがきたてる
みがき立てる	磨き立てる
みさげ果てる	みさげはてる
みさげ果てる	見下げ果てる
みせ付ける	みせつける
みせ付ける	見せ付ける
みせ掛ける	みせかける
みせ掛ける	見せ掛ける
みちびき入れる	みちびきいれる
みちびき入れる	導き入れる
みち溢れる	みちあふれる
みち溢れる	満ち溢れる
みち足りる	みちたりる
みち足りる	満ち足りる
みち足りる	満足りる
みま違える	みまちがえる
みま違える	見間違える
みみ慣れる	みみなれる
みみ慣れる	耳慣れる
み上げる	みあげる
み上げる	見上げる
み下げる	みさげる
み下げる	見下げる
み下げ果てる	みさげはてる
み下げ果てる	見下げ果てる
み付ける	みつける
み付ける	見付ける
み兼ねる	みかねる
み兼ねる	見兼ねる
み分ける	みわける
み分ける	見分ける
み切れる	みきれる
み切れる	見切れる
み初める	みそめる
み初める	見初める
み受ける	みうける
み受ける	見受ける
み合せる	みあわせる
み合せる	見合せる
み合わせる	みあわせる
み合わせる	見合わせる
み咎める	みとがめる
み咎める	見咎める
み変える	みかえる
み変える	見変える
み定める	みさだめる
み定める	見定める
み届ける	みとどける
み届ける	見届ける
み忘れる	みわすれる
み忘れる	見忘れる
み惚れる	みほれる
み惚れる	見惚れる
み慣れる	みなれる
み慣れる	見慣れる
み捨てる	みすてる
み捨てる	見捨てる
み据える	みすえる
み据える	見据える
み掛ける	みかける
み掛ける	見掛ける
み損じる	みそんじる
み損じる	見損じる
み替える	みかえる
み替える	見替える
み果てる	みはてる
み果てる	見果てる
み棄てる	みすてる
み棄てる	見棄てる
み極める	みきわめる
み極める	見極める
み比べる	みくらべる
み比べる	見比べる
み立てる	みたてる
み立てる	見立てる
み蕩れる	みとれる
み蕩れる	見蕩れる
み覚える	みおぼえる
み覚える	見覚える
み詰める	みつめる
み詰める	見詰める
み較べる	みくらべる
み較べる	見較べる
み逸れる	みはぐれる
み逸れる	見逸れる
み違える	みちがえる
み違える	見違える
み間違える	みまちがえる
み間違える	見間違える
み飽きる	みあきる
み飽きる	見飽きる
み馴れる	みなれる
み馴れる	見馴れる
むかい合わせる	むかいあわせる
むかい合わせる	向い合わせる
むかい合わせる	向かい合わせる
むかえ入れる	むかえいれる
むかえ入れる	迎え入れる
むし上げる	むしあげる
むし上げる	蒸し上げる
むすび上げる	むすびあげる
むすび上げる	結び上げる
むすび付ける	むすびつける
むすび付ける	結び付ける
むすび合せる	むすびあわせる
むすび合せる	結び合せる
むすび合わせる	むすびあわせる
むすび合わせる	結び合わせる
むせび上げる	むせびあげる
むせび上げる	咽び上げる
めくりあげる	めくりあげる
めくりあげる	めくり上げる
めくり上げる	めくりあげる
めくり上げる	めくり上げる
めぐり会せる	めぐりあわせる
めぐり会せる	巡り会せる
めぐり会わせる	めぐりあわせる
めぐり会わせる	巡り会わせる
めぐり合せる	めぐりあわせる
めぐり合せる	巡り合せる
めぐり合わせる	めぐりあわせる
めぐり合わせる	巡り合わせる
めし上げる	めしあげる
めし上げる	召し上げる
めし上げる	召上げる
めし入れる	めしいれる
めし入れる	召し入れる
めし寄せる	めしよせる
めし寄せる	召し寄せる
めし寄せる	召寄せる
めし抱える	めしかかえる
めし抱える	召し抱える
めし抱える	召抱える
めし替える	めしかえる
めし替える	召し替える
めし替える	召替える
めし連れる	めしつれる
めし連れる	召し連れる
めし連れる	召連れる
め合わせる	めあわせる
め合わせる	妻合わせる
め慣れる	めなれる
め慣れる	目慣れる
もうし上げる	もうしあげる
もうし上げる	申し上げる
もうし上げる	申上げる
もうし付ける	もうしつける
もうし付ける	申し付ける
もうし伝える	もうしつたえる
もうし伝える	申し伝える
もうし伝える	申伝える
もうし入れる	もうしいれる
もうし入れる	申し入れる
もうし入れる	申入れる
もうし兼ねる	もうしかねる
もうし兼ねる	申し兼ねる
もうし出でる	もうしいでる
もうし出でる	申し出でる
もうし出る	もうしでる
もうし出る	申し出る
もうし出る	申出る
もうし受ける	もうしうける
もうし受ける	申し受ける
もうし受ける	申受ける
もうし合せる	もうしあわせる
もうし合せる	申し合せる
もうし合わせる	もうしあわせる
もうし合わせる	申し合わせる
もうし合わせる	申合わせる
もうし添える	もうしそえる
もうし添える	申し添える
もうし添える	申添える
もうし立てる	もうしたてる
もうし立てる	申し立てる
もうし立てる	申立てる
もうし聞かせる	もうしきかせる
もうし聞かせる	申し聞かせる
もうし聞かせる	申聞かせる
もうし聞ける	もうしきける
もうし聞ける	申し聞ける
もうし述べる	もうしのべる
もうし述べる	申し述べる
もうし述べる	申述べる
もうし遅れる	もうしおくれる
もうし遅れる	申し遅れる
もうし遅れる	申遅れる
もえ出る	もえでる
もえ出る	萌え出る
もえ尽きる	もえつきる
もえ尽きる	燃え尽きる
もえ落ちる	もえおちる
もえ落ちる	燃え落ちる
もたせ掛ける	もたせかける
もたせ掛ける	もたせ掛ける
もたせ掛ける	凭せ掛ける
もたせ掛ける	持たせ掛ける
もち上げる	もちあげる
もち上げる	持ち上げる
もち上げる	持上げる
もち付ける	もちつける
もち付ける	持ち付ける
もち合せる	もちあわせる
もち合せる	持ち合せる
もち合わせる	もちあわせる
もち合わせる	持ち合わせる
もち合わせる	持合わせる
もち堪える	もちこたえる
もち堪える	持ち堪える
もち掛ける	もちかける
もち掛ける	持ち掛ける
もち掛ける	持掛ける
もち替える	もちかえる
もち替える	持ち替える
もち替える	持替える
もち添える	もちそえる
もち添える	持添える
もの慣れる	ものなれる
もの慣れる	物慣れる
もの見る	ものみる
もの見る	物見る
もの足りる	ものたりる
もの足りる	物足りる
もみ上げる	もみあげる
もみ上げる	揉み上げる
もみ入れる	もみいれる
もみ入れる	揉み入れる
もみ立てる	もみたてる
もみ立てる	揉み立てる
もやし付ける	もやしつける
もやし付ける	燃やし付ける
もらい下げる	もらいさげる
もらい下げる	貰い下げる
もらい受ける	もらいうける
もらい受ける	もらい受ける
もらい受ける	貰い受ける
もり上げる	もりあげる
もり上げる	盛り上げる
もり上げる	盛上げる
もり下げる	もりさげる
もり下げる	盛り下げる
もり下げる	盛下げる
もり付ける	もりつける
もり付ける	盛り付ける
もり入れる	もりいれる
もり入れる	盛り入れる
もり合せる	もりあわせる
もり合せる	盛り合せる
もり合わせる	もりあわせる
もり合わせる	盛り合わせる
もり合わせる	盛合わせる
もり立てる	もりたてる
もり立てる	守り立てる
もり立てる	守立てる
もり立てる	盛り立てる
もり立てる	盛立てる
もり育てる	もりそだてる
もり育てる	守り育てる
もれ聞こえる	もれきこえる
もれ聞こえる	漏れ聞こえる
もれ落ちる	もれおちる
もれ落ちる	漏れ落ちる
やき上げる	やきあげる
やき上げる	焼き上げる
やき上げる	焼上げる
やき付ける	やきつける
やき付ける	焼き付ける
やき捨てる	やきすてる
やき捨てる	焼き捨てる
やき捨てる	焼捨てる
やき過ぎる	やきすぎる
やき過ぎる	焼き過ぎる
やき過ぎる	焼過ぎる
やけ出される	やけだされる
やけ出される	焼け出される
やけ切れる	やけきれる
やけ切れる	焼け切れる
やけ失せる	やけうせる
やけ失せる	焼け失せる
やけ焦げる	やけこげる
やけ焦げる	焼け焦げる
やけ爛れる	やけただれる
やけ爛れる	焼け爛れる
やけ落ちる	やけおちる
やけ落ちる	焼け落ちる
やしない育てる	やしないそだてる
やしない育てる	養い育てる
やせ衰える	やせおとろえる
やせ衰える	やせ衰える
やせ衰える	痩せ衰える
やって退ける	やってのける
やって退ける	遣って退ける
やっ付ける	やっつける
やつれはてる	やつれはてる
やつれはてる	やつれ果てる
やつれ果てる	やつれはてる
やつれ果てる	やつれ果てる
やとい入れる	やといいれる
やとい入れる	雇い入れる
やり上げる	やりあげる
やり上げる	やり上げる
やり上げる	遣り上げる
やり付ける	やりつける
やり付ける	やり付ける
やり掛ける	やりかける
やり掛ける	やり掛ける
やり掛ける	遣り掛ける
やり替える	やりかえる
やり替える	遣り替える
やり込める	やりこめる
やり込める	やり込める
やり込める	遣り込める
やり退ける	やりのける
やり退ける	遣り退ける
やり遂げる	やりとげる
やり遂げる	やり遂げる
やり遂げる	遣り遂げる
やり過ぎる	やりすぎる
やり過ぎる	遣り過ぎる
やり違える	やりちがえる
やり違える	遣り違える
ゆい上げる	ゆいあげる
ゆい上げる	結い上げる
ゆい上げる	結上げる
ゆい付ける	ゆいつける
ゆい付ける	結い付ける
ゆい絡げる	ゆいからげる
ゆい絡げる	結い絡げる
ゆうき付ける	ゆうきづける
ゆうき付ける	勇気付ける
ゆき付ける	ゆきつける
ゆき付ける	行き付ける
ゆき別れる	ゆきわかれる
ゆき別れる	行き別れる
ゆき別れる	行別れる
ゆき合せる	ゆきあわせる
ゆき合せる	行き合せる
ゆき合わせる	ゆきあわせる
ゆき合わせる	行き合わせる
ゆき合わせる	行合わせる
ゆき廻る	ゆきめぐる
ゆき廻る	行き廻る
ゆき暮れる	ゆきくれる
ゆき暮れる	行き暮れる
ゆき暮れる	行暮れる
ゆき詰める	ゆきつめる
ゆき詰める	行詰める
ゆき過ぎる	ゆきすぎる
ゆき過ぎる	行き過ぎる
ゆき過ぎる	行過ぎる
ゆき違える	ゆきちがえる
ゆき違える	行き違える
ゆき違える	行違える
ゆすり上げる	ゆすりあげる
ゆすり上げる	揺すり上げる
ゆすり掛ける	ゆすりかける
ゆすり掛ける	強請り掛ける
ゆずり与える	ゆずりあたえる
ゆずり与える	譲り与える
ゆずり受ける	ゆずりうける
ゆずり受ける	譲り受ける
ゆでこぼれる	ゆでこぼれる
ゆでこぼれる	茹でこぼれる
ゆで上げる	うであげる
ゆで上げる	ゆであげる
ゆで上げる	茹で上げる
ゆめ見る	ゆめみる
ゆめ見る	夢見る
ゆり上げる	ゆりあげる
ゆり上げる	揺り上げる
ゆり分ける	ゆりわける
ゆり分ける	揺り分ける
ゆり分ける	淘り分ける
ゆわえ上げる	ゆわえあげる
ゆわえ上げる	結わえ上げる
ゆわえ付ける	ゆわえつける
ゆわえ付ける	結わえ付ける
よい潰れる	よいつぶれる
よい潰れる	酔い潰れる
よい痴れる	よいしれる
よい痴れる	酔い痴れる
よせ付ける	よせつける
よせ付ける	寄せ付ける
よせ入れる	よせいれる
よせ入れる	寄せ入れる
よせ合せる	よせあわせる
よせ合せる	寄せ合せる
よせ合わせる	よせあわせる
よせ合わせる	寄せ合わせる
よせ掛ける	よせかける
よせ掛ける	寄せ掛ける
よせ掛ける	寄掛ける
よせ集める	よせあつめる
よせ集める	寄せ集める
よせ集める	寄集める
よび上げる	よびあげる
よび上げる	呼び上げる
よび上げる	呼上げる
よび付ける	よびつける
よび付ける	呼び付ける
よび入れる	よびいれる
よび入れる	呼び入れる
よび入れる	呼入れる
よび寄せる	よびよせる
よび寄せる	呼び寄せる
よび寄せる	呼寄せる
よび慣れる	よびなれる
よび慣れる	呼び慣れる
よび慣れる	呼慣れる
よび捨てる	よびすてる
よび捨てる	呼び捨てる
よび掛ける	よびかける
よび掛ける	呼び掛ける
よび掛ける	呼掛ける
よび止める	よびとめる
よび止める	呼び止める
よび立てる	よびたてる
よび立てる	呼び立てる
よび立てる	呼立てる
よび続ける	よびつづける
よび続ける	呼び続ける
よび迎える	よびむかえる
よび迎える	呼び迎える
よび迎える	呼迎える
よび連れる	よびつれる
よび連れる	呼連れる
よび集める	よびあつめる
よび集める	呼び集める
よび集める	呼集める
よび馴れる	よびなれる
よび馴れる	呼び馴れる
よみま違える	よみまちがえる
よみま違える	読間違える
よみ上げる	よみあげる
よみ上げる	読み上げる
よみ上げる	読上げる
よみ付ける	よみつける
よみ付ける	読み付ける
よみ入れる	よみいれる
よみ入れる	詠み入れる
よみ入れる	詠入れる
よみ合せる	よみあわせる
よみ合せる	読み合せる
よみ合わせる	よみあわせる
よみ合わせる	読み合わせる
よみ合わせる	読合わせる
よみ慣れる	よみなれる
よみ慣れる	読み慣れる
よみ慣れる	読慣れる
よみ捨てる	よみすてる
よみ捨てる	詠捨てる
よみ捨てる	読み捨てる
よみ捨てる	読捨てる
よみ掛ける	よみかける
よみ掛ける	読み掛ける
よみ掛ける	読掛ける
よみ替える	よみかえる
よみ替える	読み替える
よみ替える	読替える
よみ比べる	よみくらべる
よみ比べる	読み比べる
よみ比べる	読比べる
よみ立てる	よみたてる
よみ立てる	読み立てる
よみ立てる	読立てる
よみ聞かせる	よみきかせる
よみ聞かせる	読み聞かせる
よみ聞かせる	読聞かせる
よみ進める	よみすすめる
よみ進める	読み進める
よみ違える	よみちがえる
よみ違える	読み違える
よみ違える	読違える
よみ馴れる	よみなれる
よみ馴れる	読み馴れる
より上げる	よりあげる
より上げる	縒り上げる
より分ける	よりわける
より分ける	選り分ける
より合せる	よりあわせる
より合せる	縒り合せる
より合わせる	よりあわせる
より合わせる	撚り合わせる
より合わせる	縒り合わせる
よろけでる	よろけでる
よろけでる	よろけ出る
よろけ出る	よろけでる
よろけ出る	よろけ出る
よわり果てる	よわりはてる
よわり果てる	弱り果てる
よ慣れる	よなれる
よ慣れる	世慣れる
りくつ付ける	りくつづける
りくつ付ける	理屈付ける
ろんじ立てる	ろんじたてる
ろんじ立てる	論じ立てる
わかち与える	わかちあたえる
わかち与える	分かち与える
わき出る	わきでる
わき出る	涌き出る
わき出る	湧き出る
わけ与える	わけあたえる
わけ与える	分け与える
わめき立てる	わめきたてる
わめき立てる	わめき立てる
わめき立てる	叫き立てる
わめき立てる	喚き立てる
わらい崩れる	わらいくずれる
わらい崩れる	笑い崩れる
わらい掛ける	わらいかける
わらい掛ける	笑い掛ける
わらい興じる	わらいきょうじる
わらい興じる	笑い興じる
わらい転ける	わらいこける
わらい転ける	笑い転ける
わらい転げる	わらいころげる
わらい転げる	笑い転げる
わり付ける	わりつける
わり付ける	割り付ける
わり入れる	わりいれる
わり入れる	割り入れる
わり切れる	わりきれる
わり切れる	割り切れる
わり切れる	割切れる
わり合せる	わりあわせる
わり合せる	割り合せる
わり当てる	わりあてる
わり当てる	割り当てる
わり当てる	割当てる
上むける	うわむける
上むける	上向ける
上りつめる	のぼりつめる
上りつめる	上り詰める
世なれる	よなれる
世なれる	世慣れる
並べあげる	ならべあげる
並べあげる	並べ上げる
並べかえる	ならべかえる
並べかえる	並べ換える
並べかえる	並べ替える
並べたてる	ならべたてる
並べたてる	並べ立てる
乗あげる	のりあげる
乗あげる	乗上げる
乗あわせる	のりあわせる
乗あわせる	乗合わせる
乗いれる	のりいれる
乗いれる	乗入れる
乗おくれる	のりおくれる
乗おくれる	乗遅れる
乗かえる	のりかえる
乗かえる	乗換える
乗かえる	乗替える
乗かける	のりかける
乗かける	乗掛ける
乗こえる	のりこえる
乗こえる	乗越える
乗すてる	のりすてる
乗すてる	乗捨てる
乗せかける	のせかける
乗せかける	乗せ掛ける
乗なれる	のりなれる
乗なれる	乗慣れる
乗りあげる	のりあげる
乗りあげる	乗り上げる
乗りあわせる	のりあわせる
乗りあわせる	乗り合せる
乗りあわせる	乗り合わせる
乗りいれる	のりいれる
乗りいれる	乗り入れる
乗りおくれる	のりおくれる
乗りおくれる	乗り遅れる
乗りかえる	のりかえる
乗りかえる	乗り換える
乗りかえる	乗り替える
乗りかける	のりかける
乗りかける	乗り掛ける
乗りこえる	のりこえる
乗りこえる	乗り越える
乗りしずめる	のりしずめる
乗りしずめる	乗り静める
乗りすてる	のりすてる
乗りすてる	乗り捨てる
乗りつける	のりつける
乗りつける	乗り付ける
乗りなれる	のりなれる
乗りなれる	乗り慣れる
乗りなれる	乗り馴れる
乞いうける	こいうける
乞いうける	乞い受ける
乾しあげる	ほしあげる
乾しあげる	乾し上げる
乾しかためる	ほしかためる
乾しかためる	乾し固める
事きれる	こときれる
事きれる	事切れる
事たりる	ことたりる
事たりる	事足りる
事よせる	ことよせる
事よせる	事寄せる
交ぜあわせる	まぜあわせる
交ぜあわせる	交ぜ合わせる
人なれる	ひとなれる
人なれる	人慣れる
仕あげる	しあげる
仕あげる	仕上げる
仕いれる	しいれる
仕いれる	仕入れる
仕かえる	しかえる
仕かえる	仕替える
仕かける	しかける
仕かける	仕掛ける
仕かねる	しかねる
仕かねる	仕兼ねる
仕そんじる	しそんじる
仕そんじる	仕損じる
仕たてあげる	したてあげる
仕たてあげる	仕立て上げる
仕たてる	したてる
仕たてる	仕立てる
仕つかえる	つかえる
仕つかえる	仕える
仕つける	しつける
仕つける	仕付ける
仕とげる	しとげる
仕とげる	仕遂げる
仕とめる	しとめる
仕とめる	仕留める
仕まいつける	しまいつける
仕まいつける	仕舞ひ付ける
仕むける	しむける
仕むける	仕向ける
仕わける	しわける
仕わける	仕分ける
仕わける	仕訳ける
仕立てあげる	したてあげる
仕立てあげる	仕立て上げる
付あわせる	つけあわせる
付あわせる	付合わせる
付かえる	つけかえる
付かえる	付替える
付くわえる	つけくわえる
付くわえる	付加える
付けあわせる	つけあわせる
付けあわせる	付け合せる
付けあわせる	付け合わせる
付けかえる	つけかえる
付けかえる	付け替える
付けくわえる	つけくわえる
付けくわえる	付け加える
付けそえる	つけそえる
付けそえる	付け添える
付けづける	づける
付けづける	付ける
付そえる	つけそえる
付そえる	付添える
仰ぎみる	あおぎみる
仰ぎみる	仰ぎ見る
仰せきける	おおせきける
仰せきける	仰せ聞ける
仰せつける	おおせつける
仰せつける	仰せつける
仰せつける	仰せ付ける
仰むける	あおむける
仰むける	仰向ける
伝いおちる	つたいおちる
伝いおちる	伝い落ちる
伝えうける	つたえうける
伝えうける	伝え受ける
伝わりおちる	つたわりおちる
伝わりおちる	伝わり落ちる
伸しあげる	のしあげる
伸しあげる	伸し上げる
位置づける	いちづける
位置づける	位置付ける
住かえる	すみかえる
住かえる	住替える
住なれる	すみなれる
住なれる	住慣れる
住みかえる	すみかえる
住みかえる	住み替える
住みなれる	すみなれる
住みなれる	住み慣れる
住みなれる	住み馴れる
住みわびる	すみわびる
住みわびる	住み侘びる
作りあげる	つくりあげる
作りあげる	作り上げる
作りあわせる	つくりあわせる
作りあわせる	作り合せる
作りあわせる	作り合わせる
作りかえる	つくりかえる
作りかえる	作り替える
作りたてる	つくりたてる
作りたてる	作り立てる
作りつける	つくりつける
作りつける	作り付ける
使いすてる	つかいすてる
使いすてる	使い捨てる
使いつける	つかいつける
使いつける	使い付ける
使いなれる	つかいなれる
使いなれる	使い慣れる
使いなれる	使い馴れる
使いわける	つかいわける
使いわける	使い分ける
価値づける	かちづける
価値づける	価値付ける
借あげる	かりあげる
借あげる	借上げる
借いれる	かりいれる
借いれる	借入れる
借うける	かりうける
借うける	借受ける
借かえる	かりかえる
借かえる	借換える
借りあげる	かりあげる
借りあげる	借り上げる
借りいれる	かりいれる
借りいれる	借り入れる
借りうける	かりうける
借りうける	借り受ける
借りかえる	かりかえる
借りかえる	借り換える
倦みつかれる	うみつかれる
倦みつかれる	倦み疲れる
備えつける	そなえつける
備えつける	備え付ける
傾れおちる	なだれおちる
傾れおちる	傾れ落ちる
働きかける	はたらきかける
働きかける	働き掛ける
元気づける	げんきづける
元気づける	元気付ける
入みだれる	いりみだれる
入みだれる	入乱れる
入りあげる	いりあげる
入りあげる	入り揚げる
入りちがえる	いりちがえる
入りちがえる	入り違える
入りみだれる	いりみだれる
入りみだれる	入り乱れる
入れあげる	いれあげる
入れあげる	入れ揚げる
入れかえる	いれかえる
入れかえる	入れ換える
入れかえる	入れ替える
入れこめる	いれこめる
入れこめる	入れ込める
入れちがえる	いれちがえる
入れちがえる	入れ違える
入れまぜる	いれまぜる
入れまぜる	入れ交ぜる
入れまぜる	入れ混ぜる
入れまぜる	入れ雑ぜる
兼そなえる	かねそなえる
兼そなえる	兼備える
兼ねそなえる	かねそなえる
兼ねそなえる	兼ね備える
凍えはてる	こごえはてる
凍えはてる	凍え果てる
凍りつめる	こおりつめる
凍りつめる	凍り詰める
凭せかける	もたせかける
凭せかける	凭せ掛ける
出いいる	いでいる
出いいる	出で居る
出おくれる	でおくれる
出おくれる	出遅れる
出かける	でかける
出かける	出掛ける
出きすぎる	できすぎる
出きすぎる	出来過ぎる
出ける	でける
出ける	出来る
出しおくれる	だしおくれる
出しおくれる	出し遅れる
出すぎる	ですぎる
出すぎる	出過ぎる
出だしおくれる	だしおくれる
出だしおくれる	出し遅れる
出っくわせる	でっくわせる
出っくわせる	出っ会せる
出ぬける	でぬける
出ぬける	出抜ける
出はずれる	ではずれる
出はずれる	出外れる
出はなれる	ではなれる
出はなれる	出離れる
出むかえる	でむかえる
出むかえる	出迎える
出来すぎる	できすぎる
出来すぎる	出来過ぎる
分かちあたえる	わかちあたえる
分かちあたえる	分かち与える
分けあたえる	わけあたえる
分けあたえる	分け与える
切あげる	きりあげる
切あげる	切上げる
切かえる	きりかえる
切かえる	切換える
切かえる	切替える
切かける	きりかける
切かける	切掛ける
切さげる	きりさげる
切さげる	切下げる
切すてる	きりすてる
切すてる	切捨てる
切たてる	きりたてる
切たてる	切立てる
切っかける	きっかける
切っかける	切っ掛ける
切つめる	きりつめる
切つめる	切詰める
切ぬける	きりぬける
切ぬける	切抜ける
切ひろげる	きりひろげる
切ひろげる	切広げる
切ふせる	きりふせる
切ふせる	切伏せる
切りあげる	きりあげる
切りあげる	切り上げる
切りかえる	きりかえる
切りかえる	切り換える
切りかえる	切り替える
切りかける	きりかける
切りかける	切り掛ける
切りさげる	きりさげる
切りさげる	切りさげる
切りさげる	切り下げる
切りすてる	きりすてる
切りすてる	切り捨てる
切りそろえる	きりそろえる
切りそろえる	きろそろえる
切りそろえる	切り揃える
切りたてる	きりたてる
切りたてる	切り立てる
切りつける	きりつける
切りつける	切り付ける
切りつめる	きりつめる
切りつめる	切り詰める
切りぬける	きりぬける
切りぬける	切り抜ける
切りひろげる	きりひろげる
切りひろげる	切り広げる
切りふせる	きりふせる
切りふせる	切り伏せる
切りわける	きりわける
切りわける	切り分ける
切れおちる	きれおちる
切れおちる	切れ落ちる
切わける	きりわける
切わける	切分ける
刈あげる	かりあげる
刈あげる	刈上げる
刈いれる	かりいれる
刈いれる	刈入れる
刈りあげる	かりあげる
刈りあげる	刈り上げる
刈りいれる	かりいれる
刈りいれる	刈り入れる
刷あげる	すりあげる
刷あげる	刷上げる
刷りあげる	すりあげる
刷りあげる	刷り上げる
刺しちがえる	さしちがえる
刺しちがえる	刺し違える
刺しとめる	さしとめる
刺しとめる	刺し止める
刺ちがえる	さしちがえる
刺ちがえる	刺違える
刻みあげる	きざみあげる
刻みあげる	刻み上げる
刻みいれる	きざみいれる
刻みいれる	刻み入れる
刻みつける	きざみつける
刻みつける	刻み付ける
剃りあげる	そりあげる
剃りあげる	剃り上げる
剃りさげる	そりさげる
剃りさげる	剃り下げる
削げおちる	そげおちる
削げおちる	削げ落ちる
剝げおちる	はげおちる
剝げおちる	剝げ落ちる
剥げおちる	はげおちる
剥げおちる	剥げ落ちる
割あてる	わりあてる
割あてる	割当てる
割きれる	わりきれる
割きれる	割切れる
割りあてる	わりあてる
割りあてる	割り当てる
割りあわせる	わりあわせる
割りあわせる	割り合せる
割りいれる	わりいれる
割りいれる	割り入れる
割りきれる	わりきれる
割りきれる	割り切れる
割りつける	わりつける
割りつける	割り付ける
力づける	ちからづける
力づける	力付ける
加えいれる	くわえいれる
加えいれる	加え入れる
助けあげる	たすけあげる
助けあげる	助け上げる
勇気づける	ゆうきづける
勇気づける	勇気付ける
勝える	かちえる
勝える	勝得る
勝すぎる	かちすぎる
勝すぎる	勝過ぎる
勝ちえる	かちえる
勝ちえる	勝ち得る
勝ちすぎる	かちすぎる
勝ちすぎる	勝ち過ぎる
勤めあげる	つとめあげる
勤めあげる	勤め上げる
印象づける	いんしょうづける
印象づける	印象付ける
取あげる	とりあげる
取あげる	取上げる
取あつめる	とりあつめる
取あつめる	取集める
取あわせる	とりあわせる
取あわせる	取合わせる
取いれる	とりいれる
取いれる	取入れる
取おさえる	とりおさえる
取おさえる	取押さえる
取おさめる	とりおさめる
取おさめる	取納める
取かえる	とりかえる
取かえる	取換える
取かえる	取替える
取かける	とりかける
取かける	取掛ける
取かたづける	とりかたづける
取かたづける	取片付ける
取かためる	とりかためる
取かためる	取固める
取きめる	とりきめる
取きめる	取決める
取こめる	とりこめる
取こめる	取籠める
取さげる	とりさげる
取さげる	取下げる
取しずめる	とりしずめる
取しずめる	取鎮める
取しらべる	とりしらべる
取しらべる	取調べる
取すてる	とりすてる
取すてる	取捨てる
取そえる	とりそえる
取そえる	取添える
取たてる	とりたてる
取たてる	取立てる
取ちがえる	とりちがえる
取ちがえる	取違える
取っかえる	とっかえる
取っかえる	取っ替える
取つめる	とりつめる
取つめる	取詰める
取とめる	とりとめる
取とめる	取留める
取ひろげる	とりひろげる
取ひろげる	取広げる
取まぎれる	とりまぎれる
取まぎれる	取紛れる
取まぜる	とりまぜる
取まぜる	取交ぜる
取まぜる	取混ぜる
取みだれる	とりみだれる
取みだれる	取乱れる
取よせる	とりよせる
取よせる	取寄せる
取りあげる	とりあげる
取りあげる	取り上げる
取りあつめる	とりあつめる
取りあつめる	取り集める
取りあわせる	とりあわせる
取りあわせる	取り合せる
取りあわせる	取り合わせる
取りいる	とりいる
取りいる	取り率る
取りいれる	とりいれる
取りいれる	取り入れる
取りおさえる	とりおさえる
取りおさえる	取り抑える
取りおさえる	取り押える
取りおさえる	取り押さえる
取りおさめる	とりおさめる
取りおさめる	取り収める
取りおさめる	取り納める
取りかえる	とりかえる
取りかえる	取り換える
取りかえる	取り替える
取りかたづける	とりかたづける
取りかたづける	取り片付ける
取りかためる	とりかためる
取りかためる	取り固める
取りきめる	とりきめる
取りきめる	取り極める
取りきめる	取り決める
取りこめる	とりこめる
取りこめる	取り籠める
取りさげる	とりさげる
取りさげる	取り下げる
取りしずめる	とりしずめる
取りしずめる	取り鎮める
取りしらべる	とりしらべる
取りしらべる	取り調べる
取りすてる	とりすてる
取りすてる	取り捨てる
取りそえる	とりそえる
取りそえる	取り添える
取りそろえる	とりそろえる
取りそろえる	取り揃える
取りたてる	とりたてる
取りたてる	取り立てる
取りちがえる	とりちがえる
取りちがえる	取り違える
取りつかれる	とりつかれる
取りつかれる	取り憑かれる
取りつける	とりつける
取りつける	取り付ける
取りつめる	とりつめる
取りつめる	取り詰める
取りとめる	とりとめる
取りとめる	取り留める
取りならべる	とりならべる
取りならべる	取り並べる
取りのける	とりのける
取りのける	取りのける
取りのける	取り除ける
取りのぼせる	とりのぼせる
取りのぼせる	取り上せる
取りのぼせる	取り逆上る
取りひろげる	とりひろげる
取りひろげる	取り広げる
取りまぎれる	とりまぎれる
取りまぎれる	取り紛れる
取りまぜる	とりまぜる
取りまぜる	取り交ぜる
取りまぜる	取り混ぜる
取りまとめる	とりまとめる
取りまとめる	取りまとめる
取りまとめる	取り纏める
取りみだれる	とりみだれる
取りみだれる	取り乱れる
取りみる	とりみる
取りみる	取り見る
取りやめる	とりやめる
取りやめる	取り止める
取りよせる	とりよせる
取りよせる	取り寄せる
取りわける	とりわける
取りわける	取り分ける
取り片づける	とりかたづける
取り片づける	取り片付ける
取わける	とりわける
取わける	取分ける
取わすれる	とりわすれる
取わすれる	取忘れる
取片づける	とりかたづける
取片づける	取片付ける
受いれる	うけいれる
受いれる	受入れる
受けいれる	うけいれる
受けいれる	受け入れる
受けいれる	受け容れる
受けそんじる	うけそんじる
受けそんじる	受け損じる
受けつける	うけつける
受けつける	受け付ける
受けつたえる	うけつたえる
受けつたえる	受け伝える
受けとめる	うけとめる
受けとめる	受け止める
受けとれる	うけとれる
受けとれる	受け取れる
口づける	くちづける
口づける	口付ける
口なれる	くちなれる
口なれる	口慣れる
口説きたてる	くどきたてる
口説きたてる	口説き立てる
叩きあげる	たたきあげる
叩きあげる	叩き上げる
叩きいれる	たたきいれる
叩きいれる	叩き入れる
叩きたてる	たたきたてる
叩きたてる	叩き立てる
叩きつける	たたきつける
叩きつける	叩き付ける
叩きふせる	たたきふせる
叩きふせる	叩き伏せる
叫きたてる	わめきたてる
叫きたてる	叫き立てる
召あげる	めしあげる
召あげる	召上げる
召かえる	めしかえる
召かえる	召替える
召かかえる	めしかかえる
召かかえる	召抱える
召しあげる	めしあげる
召しあげる	召し上げる
召しいれる	めしいれる
召しいれる	召し入れる
召しかえる	めしかえる
召しかえる	召し替える
召しかかえる	めしかかえる
召しかかえる	召し抱える
召しつれる	めしつれる
召しつれる	召し連れる
召しよせる	めしよせる
召しよせる	召し寄せる
召つれる	めしつれる
召つれる	召連れる
召よせる	めしよせる
召よせる	召寄せる
叱りつける	しかりつける
叱りつける	叱り付ける
吊りあげる	つりあげる
吊りあげる	吊り上げる
吊りさげる	つりさげる
吊りさげる	吊り下げる
吊るしあげる	つるしあげる
吊るしあげる	吊るし上げる
名づける	なづける
名づける	名付ける
名乗りでる	なのりでる
名乗りでる	名乗り出る
吐きすてる	はきすてる
吐きすてる	吐き捨てる
吐すてる	はきすてる
吐すてる	吐捨てる
向いあわせる	むかいあわせる
向いあわせる	向い合わせる
向かいあわせる	むかいあわせる
向かいあわせる	向かい合わせる
吞みつぶれる	のみつぶれる
吞みつぶれる	吞み潰れる
吠えたてる	ほえたてる
吠えたてる	吠え立てる
吸あげる	すいあげる
吸あげる	吸上げる
吸いあげる	すいあげる
吸いあげる	吸い上げる
吸いいれる	すいいれる
吸いいれる	吸い入れる
吸いつける	すいつける
吸いつける	吸い付ける
吸いよせる	すいよせる
吸いよせる	吸い寄せる
吸いれる	すいいれる
吸いれる	吸入れる
吸よせる	すいよせる
吸よせる	吸寄せる
吹あげる	ふきあげる
吹あげる	吹上げる
吹あつめる	ふきあつめる
吹あつめる	吹集める
吹あれる	ふきあれる
吹あれる	吹荒れる
吹いれる	ふきいれる
吹いれる	吹入れる
吹かえる	ふきかえる
吹かえる	吹替える
吹かける	ふきかける
吹かける	吹掛ける
吹きあげる	ふきあげる
吹きあげる	吹き上げる
吹きあつめる	ふきあつめる
吹きあつめる	吹き集める
吹きあれる	ふきあれる
吹きあれる	吹き荒れる
吹きいれる	ふきいれる
吹きいれる	吹き入れる
吹きかえる	ふきかえる
吹きかえる	吹き替える
吹きかける	ふきかける
吹きかける	吹き掛ける
吹きこぼれる	ふきこぼれる
吹きこぼれる	吹きこぼれる
吹きこぼれる	吹き零れる
吹きたてる	ふきたてる
吹きたてる	吹き立てる
吹きつける	ふきつける
吹きつける	吹き付ける
吹きでる	ふきでる
吹きでる	吹き出る
吹きぬける	ふきぬける
吹きぬける	吹き抜ける
吹きよせる	ふきよせる
吹きよせる	吹き寄せる
吹きわける	ふきわける
吹きわける	吹き分ける
吹たてる	ふきたてる
吹たてる	吹立てる
吹っかける	ふっかける
吹っかける	吹っ掛ける
吹っきれる	ふっきれる
吹っきれる	吹っ切れる
吹つける	ふきつける
吹つける	吹着ける
吹でる	ふきでる
吹でる	吹出る
吹ぬける	ふきぬける
吹ぬける	吹抜ける
吹よせる	ふきよせる
吹よせる	吹寄せる
吹わける	ふきわける
吹わける	吹分ける
呆れはてる	あきれはてる
呆れはてる	呆れ果てる
呼あげる	よびあげる
呼あげる	呼上げる
呼あつめる	よびあつめる
呼あつめる	呼集める
呼いれる	よびいれる
呼いれる	呼入れる
呼かける	よびかける
呼かける	呼掛ける
呼たてる	よびたてる
呼たてる	呼立てる
呼つれる	よびつれる
呼つれる	呼連れる
呼なれる	よびなれる
呼なれる	呼慣れる
呼びあげる	よびあげる
呼びあげる	呼び上げる
呼びあつめる	よびあつめる
呼びあつめる	呼び集める
呼びいれる	よびいれる
呼びいれる	呼び入れる
呼びかける	よびかける
呼びかける	呼び掛ける
呼びすてる	よびすてる
呼びすてる	呼び捨てる
呼びたてる	よびたてる
呼びたてる	呼び立てる
呼びつける	よびつける
呼びつける	呼び付ける
呼びつづける	よびつづける
呼びつづける	呼び続ける
呼びとめる	よびとめる
呼びとめる	呼び止める
呼びなれる	よびなれる
呼びなれる	呼び慣れる
呼びなれる	呼び馴れる
呼びむかえる	よびむかえる
呼びむかえる	呼び迎える
呼びよせる	よびよせる
呼びよせる	呼び寄せる
呼むかえる	よびむかえる
呼むかえる	呼迎える
呼よせる	よびよせる
呼よせる	呼寄せる
咲おくれる	さきおくれる
咲おくれる	咲遅れる
咲きこぼれる	さきこぼれる
咲きこぼれる	咲きこぼれる
咲きこぼれる	咲き溢れる
咲きこぼれる	咲き零れる
咲きそめる	さきそめる
咲きそめる	咲きそめる
咲きそめる	咲き初める
咲きでる	さきでる
咲きでる	咲き出る
咲きみだれる	さきみだれる
咲きみだれる	咲き乱れる
咲そめる	さきそめる
咲そめる	咲初める
咲みだれる	さきみだれる
咲みだれる	咲乱れる
咳きあげる	せきあげる
咳きあげる	咳き上げる
咽びあげる	むせびあげる
咽びあげる	咽び上げる
問あわせる	といあわせる
問あわせる	問合わせる
問いあわせる	といあわせる
問いあわせる	問い合せる
問いあわせる	問い合わせる
問いかける	といかける
問いかける	問い掛ける
問いつめる	といつめる
問いつめる	問い詰める
問かける	といかける
問かける	問掛ける
問つめる	といつめる
問つめる	問詰める
啜りあげる	すすりあげる
啜りあげる	啜り上げる
喋りたてる	しゃべりたてる
喋りたてる	喋り立てる
喚きたてる	わめきたてる
喚きたてる	喚き立てる
嗅ぎあてる	かぎあてる
嗅ぎあてる	嗅ぎ当てる
嗅ぎつける	かぎつける
嗅ぎつける	嗅ぎ付ける
嗅ぎわける	かぎわける
嗅ぎわける	嗅ぎ分ける
噛みあわせる	かみあわせる
噛みあわせる	噛み合せる
噛みあわせる	噛み合わせる
噛みしめる	かみしめる
噛みしめる	噛み締める
噛みわける	かみわける
噛みわける	噛み分ける
噦りあげる	しゃくりあげる
噦りあげる	噦り上げる
噴あげる	ふきあげる
噴あげる	噴上げる
噴きあげる	ふきあげる
噴きあげる	噴き上げる
噴きでる	ふきでる
噴きでる	噴き出る
噴でる	ふきでる
噴でる	噴出る
嚙みしめる	かみしめる
嚙みしめる	嚙み締める
嚙みまぜる	かみまぜる
嚙みまぜる	嚙み交ぜる
嚙みわける	かみわける
嚙みわける	嚙み分ける
囁きかける	ささやきかける
囁きかける	囁き掛ける
囃したてる	はやしたてる
囃したてる	囃し立てる
回しいれる	まわしいれる
回しいれる	回し入れる
回しかける	まわしかける
回しかける	回し掛ける
困じはてる	こうじはてる
困じはてる	困じ果てる
困りはてる	こまりはてる
困りはてる	困り果てる
囲いいれる	かこいいれる
囲いいれる	囲い入れる
図ぬける	ずぬける
図ぬける	図抜ける
固めあげる	かためあげる
固めあげる	固め上げる
圧しまげる	へしまげる
圧しまげる	圧し曲げる
在りあわせる	ありあわせる
在りあわせる	在り合わせる
垂れこめる	たれこめる
垂れこめる	垂れ籠める
垂れこめる	垂れ込める
垢ぬける	あかぬける
垢ぬける	垢抜ける
垣間みる	かきまみる
垣間みる	垣間見る
埋めあわせる	うめあわせる
埋めあわせる	埋め合せる
埋めあわせる	埋め合わせる
埋めたてる	うめたてる
埋めたてる	埋め立てる
執りみる	とりみる
執りみる	執り見る
基礎づける	きそづける
基礎づける	基礎付ける
堰きあげる	せきあげる
堰きあげる	堰き上げる
場なれる	ばなれる
場なれる	場慣れる
塗あげる	ぬりあげる
塗あげる	塗上げる
塗かえる	ぬりかえる
塗かえる	塗替える
塗かためる	ぬりかためる
塗かためる	塗固める
塗こめる	ぬりこめる
塗こめる	塗籠める
塗こめる	塗込める
塗たてる	ぬりたてる
塗たてる	塗立てる
塗りあげる	ぬりあげる
塗りあげる	塗り上げる
塗りかえる	ぬりかえる
塗りかえる	塗り替える
塗りかためる	ぬりかためる
塗りかためる	塗り固める
塗りこめる	ぬりこめる
塗りこめる	塗り籠める
塗りこめる	塗り込める
塗りたてる	ぬりたてる
塗りたてる	塗り立てる
塗りつける	ぬりつける
塗りつける	塗り付ける
塞きあげる	せきあげる
塞きあげる	塞き上げる
売あげる	うりあげる
売あげる	売上げる
売きれる	うりきれる
売きれる	売切れる
売さげる	うりさげる
売さげる	売下げる
売ぬける	うりぬける
売ぬける	売抜ける
売りあげる	うりあげる
売りあげる	売り上げる
売りきれる	うりきれる
売りきれる	売り切れる
売りさげる	うりさげる
売りさげる	売り下げる
売りつける	うりつける
売りつける	売り付ける
売りぬける	うりぬける
売りぬける	売り抜ける
売りひろげる	うりひろげる
売りひろげる	売り広げる
変りはてる	かわりはてる
変りはてる	変り果てる
変わりはてる	かわりはてる
変わりはてる	変わり果てる
外れおちる	はずれおちる
外れおちる	外れ落ちる
夢みる	ゆめみる
夢みる	夢見る
妻あわせる	めあわせる
妻あわせる	妻合わせる
存じあげる	ぞんじあげる
存じあげる	存じ上げる
守たてる	もりたてる
守たてる	守立てる
守りそだてる	もりそだてる
守りそだてる	守り育てる
守りたてる	もりたてる
守りたてる	守り立てる
寄あつめる	よせあつめる
寄あつめる	寄集める
寄かける	よせかける
寄かける	寄掛ける
寄せあつめる	よせあつめる
寄せあつめる	寄せ集める
寄せあわせる	よせあわせる
寄せあわせる	寄せ合せる
寄せあわせる	寄せ合わせる
寄せいれる	よせいれる
寄せいれる	寄せ入れる
寄せかける	よせかける
寄せかける	寄せ掛ける
寄せつける	よせつける
寄せつける	寄せ付ける
寝あきる	ねあきる
寝あきる	寝飽きる
寝かしつける	ねかしつける
寝かしつける	寝かし付ける
寝くたれる	ねくたれる
寝くたれる	寝腐れる
寝ざめる	ねざめる
寝ざめる	寝覚める
寝すぎる	ねすぎる
寝すぎる	寝過ぎる
寝せつける	ねせつける
寝せつける	寝せ付ける
寝たおれる	ねたおれる
寝たおれる	寝倒れる
寝ちがえる	ねちがえる
寝ちがえる	寝違える
寝はれる	ねはれる
寝はれる	寝腫れる
寝ほれる	ねほれる
寝ほれる	寝惚れる
寝ぼける	ねぼける
寝ぼける	寝ぼける
寝ぼける	寝惚ける
寝みだれる	ねみだれる
寝みだれる	寝乱れる
寝わすれる	ねわすれる
寝わすれる	寝忘れる
封じこめる	ふうじこめる
封じこめる	封じ込める
封じほうじる	ほうじる
封じほうじる	封じる
射あてる	いあてる
射あてる	射中てる
射あてる	射当てる
射かける	いかける
射かける	射掛ける
射すくめる	いすくめる
射すくめる	射竦める
射たてる	いたてる
射たてる	射立てる
射つける	いつける
射つける	射付ける
射とめる	いとめる
射とめる	射止める
射りつける	いりつける
射りつける	射り付ける
尋ねあてる	たずねあてる
尋ねあてる	尋ね当てる
尋ねあわせる	たずねあわせる
尋ねあわせる	尋ね合せる
尋ねあわせる	尋ね合わせる
尋ねかける	たずねかける
尋ねかける	尋ね掛ける
尋ねたんねる	たんねる
尋ねたんねる	尋ねる
導きいれる	みちびきいれる
導きいれる	導き入れる
尽きはてる	つきはてる
尽きはてる	尽き果てる
尽はてる	つきはてる
尽はてる	尽果てる
居あわせる	いあわせる
居あわせる	居合せる
居あわせる	居合わせる
居おる	おる
居おる	居る
居ながれる	いながれる
居ながれる	居流れる
居びたれる	いびたれる
居びたれる	居浸れる
届けでる	とどけでる
届けでる	届け出る
届でる	とどけでる
届でる	届出る
屡みる	しばみる
屡みる	屡見る
屢みる	しばみる
屢みる	屢見る
履かえる	はきかえる
履かえる	履替える
履きかえる	はきかえる
履きかえる	履き替える
履きすてる	はきすてる
履きすてる	履き捨てる
履きちがえる	はきちがえる
履きちがえる	履き違える
履きつける	はきつける
履きつける	履きつける
履すてる	はきすてる
履すてる	履捨てる
履ちがえる	はきちがえる
履ちがえる	履違える
崩れおちる	くずれおちる
崩れおちる	崩れ落ちる
巡りあわせる	めぐりあわせる
巡りあわせる	巡り会せる
巡りあわせる	巡り会わせる
巡りあわせる	巡り合せる
巡りあわせる	巡り合わせる
差あげる	さしあげる
差あげる	差上げる
差あてる	さしあてる
差あてる	差当てる
差いれる	さしいれる
差いれる	差入れる
差おさえる	さしおさえる
差おさえる	差押さえる
差かえる	さしかえる
差かえる	差換える
差かえる	差替える
差かける	さしかける
差かける	差掛ける
差かためる	さしかためる
差かためる	差固める
差くわえる	さしくわえる
差くわえる	差加える
差こえる	さしこえる
差こえる	差越える
差しあげる	さしあげる
差しあげる	差し上げる
差しあてる	さしあてる
差しあてる	差し当てる
差しいれる	さしいれる
差しいれる	差し入れる
差しおさえる	さしおさえる
差しおさえる	差し押える
差しおさえる	差し押さえる
差しかえる	さしかえる
差しかえる	差し換える
差しかえる	差し替える
差しかける	さしかける
差しかける	差し掛ける
差しかためる	さしかためる
差しかためる	差し固める
差しくわえる	さしくわえる
差しくわえる	差し加える
差しこえる	さしこえる
差しこえる	差し越える
差しそえる	さしそえる
差しそえる	差し添える
差したてる	さしたてる
差したてる	差し立てる
差しちがえる	さしちがえる
差しちがえる	差し違える
差しつかえる	さしつかえる
差しつかえる	差し支える
差しつける	さしつける
差しつける	差し付ける
差しでる	さしでる
差しでる	差し出る
差しとめる	さしとめる
差しとめる	差し止める
差しのべる	さしのべる
差しのべる	差し伸べる
差しのべる	差し延べる
差しひかえる	さしひかえる
差しひかえる	差し控える
差しむける	さしむける
差しむける	差し向ける
差しもつれる	さしもつれる
差しもつれる	差し縺れる
差そえる	さしそえる
差そえる	差添える
差たてる	さしたてる
差たてる	差立てる
差ちがえる	さしちがえる
差ちがえる	差違える
差つかえる	さしつかえる
差つかえる	差支える
差でる	さしでる
差でる	差出る
差ひかえる	さしひかえる
差ひかえる	差控える
差むける	さしむける
差むける	差向ける
巻あげる	まきあげる
巻あげる	巻上げる
巻あげる	巻揚げる
巻かえる	まきかえる
巻かえる	巻替える
巻きあげる	まきあげる
巻きあげる	巻き上げる
巻きあげる	巻き揚げる
巻きいれる	まきいれる
巻きいれる	巻き入れる
巻きつける	まきつける
巻きつける	巻き付ける
干あげる	ほしあげる
干あげる	干上げる
干かためる	ほしかためる
干かためる	干固める
干しあげる	ほしあげる
干しあげる	干し上げる
干しかためる	ほしかためる
干しかためる	干し固める
建かえる	たてかえる
建かえる	建替える
建てかえる	たてかえる
建てかえる	建て替える
建てつける	たてつける
建てつける	建て付ける
弁じたてる	べんじたてる
弁じたてる	弁じ立てる
弁じつける	べんじつける
弁じつける	弁じ付ける
引あける	ひきあける
引あける	引開ける
引あげる	ひきあげる
引あげる	引上げる
引あげる	引揚げる
引あてる	ひきあてる
引あてる	引当てる
引あわせる	ひきあわせる
引あわせる	引合わせる
引いれる	ひきいれる
引いれる	引入れる
引うける	ひきうける
引うける	引受ける
引かえる	ひきかえる
引かえる	引換える
引かえる	引替える
引かける	ひきかける
引かける	引掛ける
引きあげる	ひきあげる
引きあげる	引き上げる
引きあげる	引き揚げる
引きあてる	ひきあてる
引きあてる	引き当てる
引きあわせる	ひきあわせる
引きあわせる	引き合せる
引きあわせる	引き合わせる
引きいれる	ひきいれる
引きいれる	引き入れる
引きうける	ひきうける
引きうける	引き受ける
引きかえる	ひきかえる
引きかえる	引き換える
引きかえる	引き替える
引きかける	ひきかける
引きかける	引き掛ける
引きくらべる	ひきくらべる
引きくらべる	引き比べる
引きくらべる	引き較べる
引きくるめる	ひきくるめる
引きくるめる	引き括める
引きこめる	ひきこめる
引きこめる	引き込める
引きさげる	ひきさげる
引きさげる	引き下げる
引きしめる	ひきしめる
引きしめる	引き締める
引きすえる	ひきすえる
引きすえる	引き据える
引きずりあげる	ひきずりあげる
引きずりあげる	引きずり上げる
引きずりいれる	ひきずりいれる
引きずりいれる	引きずり入れる
引きそろえる	ひきそろえる
引きそろえる	引き揃える
引きたてる	ひきたてる
引きたてる	引き立てる
引きちがえる	ひきちがえる
引きちがえる	引き違える
引きつける	ひきつける
引きつける	引き付ける
引きつめる	ひきつめる
引きつめる	引き詰める
引きつれる	ひきつれる
引きつれる	引き攣れる
引きつれる	引き連れる
引きとどめる	ひきとどめる
引きとどめる	引きとどめる
引きとめる	ひきとめる
引きとめる	引き止める
引きとめる	引き留める
引きのける	ひきのける
引きのける	引き退ける
引きよせる	ひきよせる
引きよせる	引き寄せる
引きわける	ひきわける
引きわける	引き分ける
引くらべる	ひきくらべる
引くらべる	引比べる
引こめる	ひきこめる
引こめる	引込める
引さげる	ひきさげる
引さげる	引下げる
引しめる	ひきしめる
引しめる	引締める
引すえる	ひきすえる
引すえる	引据える
引たてる	ひきたてる
引たてる	引立てる
引ちがえる	ひきちがえる
引ちがえる	引違える
引っあげる	ひっぱりあげる
引っあげる	引っ張り上げる
引っいれる	ひっぱりいれる
引っいれる	引っ張り入れる
引っかかえる	ひっかかえる
引っかかえる	引っ抱える
引っかける	ひっかける
引っかける	引っ掛ける
引っこめる	ひっこめる
引っこめる	引っ込める
引っさげる	ひっさげる
引っさげる	引っ下げる
引ったてる	ひったてる
引ったてる	引っ立てる
引っつける	ひっつける
引っつける	引っ付ける
引っつめる	ひっつめる
引っつめる	引っ詰める
引っひっかかえる	ひっかかえる
引っひっかかえる	引っ抱える
引っひっかける	ひっかける
引っひっかける	引っ懸ける
引っひっかける	引っ掛ける
引っひっからげる	ひっからげる
引っひっからげる	引っ紮げる
引っひっからげる	引っ絡げる
引っひっくるめる	ひっくるめる
引っひっくるめる	引っ括める
引っひっこめる	ひっこめる
引っひっこめる	引っ込める
引っひっさげる	ひっさげる
引っひっさげる	引っ下げる
引っひっさげる	引っ提げる
引っひったてる	ひったてる
引っひったてる	引っ立てる
引っひっつかまえる	ひっつかまえる
引っひっつかまえる	引っ捕まえる
引っひっつかまえる	引っ掴まえる
引っひっつける	ひっつける
引っひっつける	引っ付ける
引っひっつめる	ひっつめる
引っひっつめる	引っ詰める
引っひっとらえる	ひっとらえる
引っひっとらえる	引っ捕える
引っひっとらえる	引っ捕らえる
引っ張りあげる	ひっぱりあげる
引っ張りあげる	引っ張り上げる
引つめる	ひきつめる
引つめる	引詰める
引つれる	ひきつれる
引つれる	引連れる
引とめる	ひきとめる
引とめる	引留める
引よせる	ひきよせる
引よせる	引寄せる
引わける	ひきわける
引わける	引分ける
弱りはてる	よわりはてる
弱りはてる	弱り果てる
張あげる	はりあげる
張あげる	張上げる
張かえる	はりかえる
張かえる	張替える
張きれる	はりきれる
張きれる	張切れる
張さける	はりさける
張さける	張裂ける
張つめる	はりつめる
張つめる	張詰める
張りあげる	はりあげる
張りあげる	張り上げる
張りあわせる	はりあわせる
張りあわせる	張り合せる
張りあわせる	張り合わせる
張りかえる	はりかえる
張りかえる	張り替える
張りきれる	はりきれる
張りきれる	張り切れる
張りさける	はりさける
張りさける	張り裂ける
張りつける	はりつける
張りつける	張り付ける
張りつめる	はりつめる
張りつめる	張り詰める
強請りかける	ゆすりかける
強請りかける	強請り掛ける
当てつける	あてつける
当てつける	当て付ける
当てはめる	あてはめる
当てはめる	当てはめる
当てはめる	当て嵌める
彫あげる	ほりあげる
彫あげる	彫上げる
彫りあげる	ほりあげる
彫りあげる	彫り上げる
彫りいれる	ほりいれる
彫りいれる	彫り入れる
彫りつける	ほりつける
彫りつける	彫り付ける
待あわせる	まちあわせる
待あわせる	待合わせる
待うける	まちうける
待うける	待受ける
待かまえる	まちかまえる
待かまえる	待構える
待こがれる	まちこがれる
待こがれる	待焦がれる
待ちあぐねる	まちあぐねる
待ちあぐねる	待ち倦ねる
待ちあわせる	まちあわせる
待ちあわせる	待ち合せる
待ちあわせる	待ち合わせる
待ちうける	まちうける
待ちうける	待ち受ける
待ちかねる	まちかねる
待ちかねる	待ち兼ねる
待ちかまえる	まちかまえる
待ちかまえる	待ち構える
待ちくたびれる	まちくたびれる
待ちくたびれる	待ちくたびれる
待ちくたびれる	待ち草臥れる
待ちこがれる	まちこがれる
待ちこがれる	待ち焦がれる
待ちつける	まちつける
待ちつける	待ち付ける
待ちぶせる	まちぶせる
待ちぶせる	待ち伏せる
待ちもうける	まちもうける
待ちもうける	待ち設ける
待ちわびる	まちわびる
待ちわびる	待ちわびる
待ちわびる	待ち侘びる
後ろみる	うしろみる
後ろみる	後ろ見る
微笑みかける	ほほえみかける
微笑みかける	微笑み掛ける
心える	こころえる
心える	心得る
心づける	こころづける
心づける	心付ける
忍びでる	しのびでる
忍びでる	忍び出る
怒りつける	おこりつける
怒りつける	怒り付ける
怒鳴りあげる	どなりあげる
怒鳴りあげる	怒鳴り上げる
怒鳴りたてる	どなりたてる
怒鳴りたてる	怒鳴り立てる
怒鳴りつける	どなりつける
怒鳴りつける	怒鳴り付ける
思いあぐねる	おもいあぐねる
思いあぐねる	思い倦ねる
思いあわせる	おもいあわせる
思いあわせる	思い合せる
思いあわせる	思い合わせる
思いうかべる	おもいうかべる
思いうかべる	思い浮かべる
思いうかべる	思い浮べる
思いくずれる	おもいくずれる
思いくずれる	思い頽れる
思いくらべる	おもいくらべる
思いくらべる	思い比べる
思いこがれる	おもいこがれる
思いこがれる	思い焦がれる
思いさだめる	おもいさだめる
思いさだめる	思い定める
思いしめる	おもいしめる
思いしめる	思い染める
思いしらせる	おもいしらせる
思いしらせる	思い知らせる
思いちがえる	おもいちがえる
思いちがえる	思い違える
思いつづける	おもいつづける
思いつづける	思い続ける
思いつめる	おもいつめる
思いつめる	思い詰める
思いひがめる	おもいひがめる
思いひがめる	思い僻める
思いみだれる	おもいみだれる
思いみだれる	思い乱れる
思いみる	おもいみる
思いみる	思い見る
思いもうける	おもいもうける
思いもうける	思い設ける
急きあげる	せきあげる
急きあげる	急き上げる
急きたてる	せきたてる
急きたてる	急き立てる
恋いこがれる	こいこがれる
恋いこがれる	恋い焦がれる
恋いそめる	こいそめる
恋いそめる	恋い初める
恋こがれる	こいこがれる
恋こがれる	恋焦がれる
恋そめる	こいそめる
恋そめる	恋初める
息たえる	いきたえる
息たえる	息絶える
意味づける	いみづける
意味づける	意味付ける
懸けはなれる	かけはなれる
懸けはなれる	懸け離れる
懸はなれる	かけはなれる
懸はなれる	懸離れる
成しとげる	なしとげる
成しとげる	成し遂げる
成とげる	なしとげる
成とげる	成遂げる
成はてる	なりはてる
成はてる	成果てる
成りおおせる	なりおおせる
成りおおせる	成り果せる
成りはてる	なりはてる
成りはてる	成り果てる
扇ぎたてる	あおぎたてる
扇ぎたてる	扇ぎ立てる
手なれる	てなれる
手なれる	手慣れる
手むける	たむける
手むける	手向ける
手繰あげる	たぐりあげる
手繰あげる	手繰上げる
手繰よせる	たぐりよせる
手繰よせる	手繰寄せる
手繰りあげる	たぐりあげる
手繰りあげる	手繰り上げる
手繰りよせる	たぐりよせる
手繰りよせる	手繰り寄せる
打あける	うちあける
打あける	打明ける
打あげる	うちあげる
打あげる	ぶちあげる
打あげる	打上げる
打あげる	打揚げる
打あてる	うちあてる
打あてる	打当てる
打あわせる	うちあわせる
打あわせる	打合わせる
打かける	うちかける
打かける	打掛ける
打すえる	うちすえる
打すえる	打据える
打すぎる	うちすぎる
打すぎる	打過ぎる
打すてる	うちすてる
打すてる	打捨てる
打たえる	うちたえる
打たえる	打絶える
打たてる	うちたてる
打たてる	打立てる
打ちあける	うちあける
打ちあける	ぶちあける
打ちあける	打ち明ける
打ちあける	打ち開ける
打ちあげる	うちあげる
打ちあげる	ぶちあげる
打ちあげる	打ち上げる
打ちあげる	打ち揚げる
打ちあてる	うちあてる
打ちあてる	打ち当てる
打ちあわせる	うちあわせる
打ちあわせる	打ち合せる
打ちあわせる	打ち合わせる
打ちかえる	うちかえる
打ちかえる	打ち替える
打ちかける	うちかける
打ちかける	打ち懸ける
打ちかける	打ち掛ける
打ちがえる	うちちがえる
打ちがえる	打違える
打ちきょうじる	うちきょうじる
打ちきょうじる	打ち興じる
打ちきれる	ぶちきれる
打ちきれる	打ち切れる
打ちしおれる	うちしおれる
打ちしおれる	打ち萎れる
打ちすえる	うちすえる
打ちすえる	打ち据える
打ちすぎる	うちすぎる
打ちすぎる	打ち過ぎる
打ちすてる	うちすてる
打ちすてる	打ち捨てる
打ちそんじる	うちそんじる
打ちそんじる	打ち損じる
打ちたえる	うちたえる
打ちたえる	打ち絶える
打ちたてる	うちたてる
打ちたてる	打ち立てる
打ちちがえる	うちちがえる
打ちちがえる	打ち違える
打ちつける	うちつける
打ちつける	打ち付ける
打ちつれる	うちつれる
打ちつれる	打ち連れる
打ちとける	うちとける
打ちとける	打ち解ける
打ちとめる	うちとめる
打ちとめる	打ち止める
打ちとめる	打ち留める
打ちながめる	うちながめる
打ちながめる	打ち眺める
打ちはじめる	うちはじめる
打ちはじめる	打ち始める
打ちひそめる	うちひそめる
打ちひそめる	打ち顰める
打ちふるえる	うちふるえる
打ちふるえる	打ち震える
打ちぶちあける	ぶちあける
打ちぶちあける	打ち明ける
打ちぶちあける	打ち開ける
打ちぶちあげる	ぶちあげる
打ちぶちあげる	打ち上げる
打ちぶちきれる	ぶちきれる
打ちぶちきれる	打ち切れる
打ちぶちまける	ぶちまける
打ちぶちまける	打ちまける
打ちみる	うちみる
打ちみる	打ち廻る
打ちみる	打ち見る
打ちよせる	うちよせる
打ちよせる	打ち寄せる
打ちわすれる	うちわすれる
打ちわすれる	打ち忘れる
打ちわびる	うちわびる
打ちわびる	打ち詫びる
打っかける	ぶっかける
打っかける	打っ掛ける
打っきれる	ぶっきれる
打っきれる	打っ切れる
打ってでる	うってでる
打ってでる	打って出る
打つれる	うちつれる
打つれる	打連れる
打とける	うちとける
打とける	打解ける
打とめる	うちとめる
打とめる	打留める
打ながめる	うちながめる
打ながめる	打眺める
打ふるえる	うちふるえる
打ふるえる	打震える
打まぎれる	うちまぎれる
打まぎれる	打紛れる
打みる	うちみる
打みる	打見る
打よせる	うちよせる
打よせる	打寄せる
打わすれる	うちわすれる
打わすれる	打忘れる
打んなげる	ぶんなげる
打んなげる	打ん投げる
払いあげる	はらいあげる
払いあげる	払い上げる
払いさげる	はらいさげる
払いさげる	払い下げる
払いのける	はらいのける
払いのける	払いのける
払いのける	払い除ける
払さげる	はらいさげる
払さげる	払下げる
扱きまぜる	こきまぜる
扱きまぜる	扱き混ぜる
抉じあける	こじあける
抉じあける	抉じ開ける
抉じいれる	こじいれる
抉じいれる	抉じ入れる
投いれる	なげいれる
投いれる	投入れる
投かける	なげかける
投かける	投掛ける
投げあげる	なげあげる
投げあげる	投げ上げる
投げあたえる	なげあたえる
投げあたえる	投げ与える
投げいれる	なげいれる
投げいれる	投げ入れる
投げかける	なげかける
投げかける	投げ掛ける
投げすてる	なげすてる
投げすてる	投げ捨てる
投げすてる	投げ棄てる
投げつける	なげつける
投げつける	投げ付ける
投すてる	なげすてる
投すてる	投捨てる
折かさねる	おりかさねる
折かさねる	折重ねる
折まげる	おりまげる
折まげる	折曲げる
折りあげる	おりあげる
折りあげる	折り上げる
折りかさねる	おりかさねる
折りかさねる	折り重ねる
折りまげる	おりまげる
折りまげる	折り曲げる
抜あわせる	ぬきあわせる
抜あわせる	抜合わせる
抜きあわせる	ぬきあわせる
抜きあわせる	抜き合せる
抜きあわせる	抜き合わせる
抜きつれる	ぬきつれる
抜きつれる	抜き連れる
抜きでる	ぬきでる
抜きでる	ぬきんでる
抜きでる	抜きん出る
抜きでる	抜き出る
抜きんでる	ぬきんでる
抜きんでる	抜きん出る
抜けおちる	ぬけおちる
抜けおちる	抜け落ちる
抜けでる	ぬけでる
抜けでる	抜け出る
抜つれる	ぬきつれる
抜つれる	抜連れる
抜でる	ぬきでる
抜でる	抜出る
抱あげる	だきあげる
抱あげる	抱上げる
抱あわせる	だきあわせる
抱あわせる	抱合わせる
抱いれる	だきいれる
抱いれる	抱入れる
抱えあげる	かかえあげる
抱えあげる	抱え上げる
抱えいれる	かかえいれる
抱えいれる	抱え入れる
抱えおりる	かかえおりる
抱えおりる	抱え下りる
抱きあげる	だきあげる
抱きあげる	抱き上げる
抱きあわせる	だきあわせる
抱きあわせる	抱き合せる
抱きあわせる	抱き合わせる
抱きかかえる	だきかかえる
抱きかかえる	抱き抱える
抱きしめる	だきしめる
抱きしめる	抱き締める
抱きすくめる	だきすくめる
抱きすくめる	抱き竦める
抱きとめる	だきとめる
抱きとめる	抱き止める
抱きとめる	抱き留める
抱きよせる	だきよせる
抱きよせる	抱き寄せる
抱しめる	だきしめる
抱しめる	抱締める
抱とめる	だきとめる
抱とめる	抱留める
抱よせる	だきよせる
抱よせる	抱寄せる
押あける	おしあける
押あける	押開ける
押あげる	おしあげる
押あげる	押上げる
押あてる	おしあてる
押あてる	押当てる
押いれる	おしいれる
押いれる	押入れる
押かける	おしかける
押かける	押掛ける
押こめる	おしこめる
押こめる	押込める
押さえつける	おさえつける
押さえつける	押さえ付ける
押さげる	おしさげる
押さげる	押下げる
押しあける	おしあける
押しあける	押し開ける
押しあげる	おしあげる
押しあげる	押し上げる
押しあてる	おしあてる
押しあてる	押し当てる
押しいれる	おしいれる
押しいれる	押し入れる
押しかける	おしかける
押しかける	押し掛ける
押しこめる	おしこめる
押しこめる	押し込める
押しこらえる	おしこらえる
押しこらえる	押しこらえる
押しさげる	おしさげる
押しさげる	押し下げる
押ししずめる	おししずめる
押ししずめる	押し沈める
押ししずめる	押し鎮める
押しすすめる	おしすすめる
押しすすめる	押し進める
押しずめる	おししずめる
押しずめる	押沈める
押しずめる	押鎮める
押したてる	おしたてる
押したてる	押し立てる
押しつける	おしつける
押しつける	押し付ける
押しつめる	おしつめる
押しつめる	押し詰める
押しとどめる	おしとどめる
押しとどめる	押しとどめる
押しとめる	おしとめる
押しとめる	押し止める
押しならべる	おしならべる
押しならべる	押し並べる
押しのける	おしのける
押しのける	押しのける
押しのける	押し退ける
押しひろげる	おしひろげる
押しひろげる	押し広げる
押しひろめる	おしひろめる
押しひろめる	押し広める
押しふせる	おしふせる
押しふせる	押し伏せる
押しまげる	おしまげる
押しまげる	押し曲げる
押しむける	おしむける
押しむける	押し向ける
押しよせる	おしよせる
押しよせる	押し寄せる
押しわける	おしわける
押しわける	押し分ける
押すすめる	おしすすめる
押すすめる	押進める
押たてる	おしたてる
押たてる	押立てる
押っかぶせる	おっかぶせる
押っかぶせる	押っ被せる
押ったてる	おったてる
押ったてる	押っ立てる
押ったまげる	おったまげる
押ったまげる	押っ魂消る
押っつける	おっつける
押っつける	押っ付ける
押っぱじめる	おっぱじめる
押っぱじめる	押っ始める
押っぴろげる	おっぴろげる
押っぴろげる	押っ広げる
押っぷせる	おっぷせる
押っぷせる	押っ伏せる
押つめる	おしつめる
押つめる	押詰める
押ひろげる	おしひろげる
押ひろげる	押広げる
押ひろめる	おしひろめる
押ひろめる	押広める
押ふせる	おしふせる
押ふせる	押伏せる
押まげる	おしまげる
押まげる	押曲げる
押むける	おしむける
押むける	押向ける
押よせる	おしよせる
押よせる	押寄せる
押わける	おしわける
押わける	押分ける
担ぎあげる	かつぎあげる
担ぎあげる	担ぎ上げる
担ぎいれる	かつぎいれる
担ぎいれる	担ぎ入れる
招きいれる	まねきいれる
招きいれる	招き入れる
招きよせる	まねきよせる
招きよせる	招き寄せる
招じいれる	しょうじいれる
招じいれる	招じ入れる
括しあげる	くくしあげる
括しあげる	括し上げる
括りあげる	くくりあげる
括りあげる	括り上げる
括りつける	くくりつける
括りつける	括り付ける
拭きたてる	ふきたてる
拭きたてる	拭き立てる
拾いあげる	ひろいあげる
拾いあげる	拾い上げる
拾いあつめる	ひろいあつめる
拾いあつめる	拾い集める
持あげる	もちあげる
持あげる	持上げる
持あわせる	もちあわせる
持あわせる	持合わせる
持かえる	もちかえる
持かえる	持替える
持かける	もちかける
持かける	持掛ける
持そえる	もちそえる
持そえる	持添える
持たせかける	もたせかける
持たせかける	持たせ掛ける
持ちあげる	もちあげる
持ちあげる	持ち上げる
持ちあわせる	もちあわせる
持ちあわせる	持ち合せる
持ちあわせる	持ち合わせる
持ちかえる	もちかえる
持ちかえる	持ち替える
持ちかける	もちかける
持ちかける	持ち掛ける
持ちこたえる	もちこたえる
持ちこたえる	持ちこたえる
持ちこたえる	持ち堪える
持ちつける	もちつける
持ちつける	持ち付ける
指かける	さしかける
指かける	指掛ける
指しかける	さしかける
指しかける	指し掛ける
挟みあげる	はさみあげる
挟みあげる	挟み上げる
挟みいれる	はさみいれる
挟みいれる	挟み入れる
挟みつける	はさみつける
挟みつける	挟み付ける
振あげる	ふりあげる
振あげる	振上げる
振あてる	ふりあてる
振あてる	振当てる
振かえる	ふりかえる
振かえる	振替える
振かける	ふりかける
振かける	振掛ける
振すてる	ふりすてる
振すてる	振捨てる
振たてる	ふりたてる
振たてる	振立てる
振むける	ふりむける
振むける	振向ける
振りあげる	ふりあげる
振りあげる	振り上げる
振りあてる	ふりあてる
振りあてる	振り当てる
振りいれる	ふりいれる
振りいれる	振り入れる
振りかえる	ふりかえる
振りかえる	振り替える
振りかける	ふりかける
振りかける	振り懸ける
振りかける	振り掛ける
振りきれる	ふりきれる
振りきれる	振り切れる
振りさけみる	ふりさけみる
振りさけみる	振り放け見る
振りすてる	ふりすてる
振りすてる	振り捨てる
振りたてる	ふりたてる
振りたてる	振り立てる
振りつける	ふりつける
振りつける	振り付ける
振りむける	ふりむける
振りむける	振り向ける
振りわける	ふりわける
振りわける	振り分ける
振り放けみる	ふりさけみる
振り放けみる	振り放け見る
振わける	ふりわける
振わける	振分ける
挿げかえる	すげかえる
挿げかえる	挿げ替える
捏ちあげる	でっちあげる
捏ちあげる	捏ち上げる
捏ねあげる	こねあげる
捏ねあげる	捏ね上げる
捏ねあわせる	こねあわせる
捏ねあわせる	捏ね合せる
捏ねあわせる	捏ね合わせる
捏ねつくねる	つくねる
捏ねつくねる	捏ねる
捜しあてる	さがしあてる
捜しあてる	捜し当てる
捜しもとめる	さがしもとめる
捜しもとめる	捜し求める
捩じあける	ねじあける
捩じあける	捩じ開ける
捩じあげる	ねじあげる
捩じあげる	捩じ上げる
捩じふせる	ねじふせる
捩じふせる	捩じ伏せる
捩じまげる	ねじまげる
捩じまげる	捩じ曲げる
捩じむける	ねじむける
捩じむける	捩じ向ける
捩じりあげる	ねじりあげる
捩じりあげる	捩じり上げる
据えつける	すえつける
据えつける	据え付ける
捲きあげる	まきあげる
捲きあげる	捲き上げる
捲しあげる	まくしあげる
捲しあげる	捲し上げる
捲しかける	まくしかける
捲しかける	捲し掛ける
捲したてる	まくしたてる
捲したてる	捲し立てる
捲りあげる	まくりあげる
捲りあげる	捲り上げる
捻じあける	ねじあける
捻じあける	捻じ開ける
捻じあげる	ねじあげる
捻じあげる	捻じ上げる
捻じふせる	ねじふせる
捻じふせる	捻じ伏せる
捻じまげる	ねじまげる
捻じまげる	捻じ曲げる
捻じむける	ねじむける
捻じむける	捻じ向ける
掃きあつめる	はきあつめる
掃きあつめる	掃き集める
掃きいれる	はきいれる
掃きいれる	掃き入れる
掃ききよめる	はききよめる
掃ききよめる	掃き清める
掃きすてる	はきすてる
掃きすてる	掃き捨てる
掃きためる	はきためる
掃きためる	掃きためる
掃きよせる	はきよせる
掃きよせる	掃き寄せる
掃きよめる	はききよめる
掃きよめる	掃清める
掃すてる	はきすてる
掃すてる	掃捨てる
掃よせる	はきよせる
掃よせる	掃寄せる
掏りかえる	すりかえる
掏りかえる	掏り替える
掘あてる	ほりあてる
掘あてる	掘当てる
掘さげる	ほりさげる
掘さげる	掘下げる
掘たてる	ほりたてる
掘たてる	掘立てる
掘りあてる	ほりあてる
掘りあてる	掘り当てる
掘りいれる	ほりいれる
掘りいれる	掘り入れる
掘りさげる	ほりさげる
掘りさげる	掘り下げる
掛あわせる	かけあわせる
掛あわせる	掛合わせる
掛かえる	かけかえる
掛かえる	掛替える
掛けあわせる	かけあわせる
掛けあわせる	掛け合せる
掛けあわせる	掛け合わせる
掛けかえる	かけかえる
掛けかえる	掛け替える
掛けちがえる	かけちがえる
掛けちがえる	掛け違える
掛けつらねる	かけつらねる
掛けつらねる	掛け連ねる
掛けはなれる	かけはなれる
掛けはなれる	掛け離れる
掛はなれる	かけはなれる
掛はなれる	掛離れる
探しあてる	さがしあてる
探しあてる	探し当てる
探しもとめる	さがしもとめる
探しもとめる	探し求める
探りあてる	さぐりあてる
探りあてる	探り当てる
接ぎあわせる	はぎあわせる
接ぎあわせる	接ぎ合わせる
推あてる	おしあてる
推あてる	推当てる
推しあてる	おしあてる
推しあてる	推し当てる
推しすすめる	おしすすめる
推しすすめる	推し進める
推すすめる	おしすすめる
推すすめる	推進める
掬いあげる	すくいあげる
掬いあげる	掬いあげる
掬いあげる	掬い上げる
掬いいれる	すくいいれる
掬いいれる	掬い入れる
掴みあげる	つかみあげる
掴みあげる	掴み上げる
掴みいれる	つかみいれる
掴みいれる	掴み入れる
掻きあげる	かきあげる
掻きあげる	掻き上げる
掻きあげる	掻き揚げる
掻きあつめる	かきあつめる
掻きあつめる	掻き集める
掻きあわせる	かきあわせる
掻きあわせる	掻き合せる
掻きあわせる	掻き合わせる
掻きいれる	かきいれる
掻きいれる	掻き入れる
掻ききえる	かききえる
掻ききえる	掻き消える
掻きくれる	かきくれる
掻きくれる	掻き暗れる
掻きくれる	掻き暮れる
掻きたてる	かきたてる
掻きたてる	掻き立てる
掻きなでる	かきなでる
掻きなでる	掻き撫でる
掻きのける	かきのける
掻きのける	掻き退ける
掻きまぜる	かきまぜる
掻きまぜる	掻き混ぜる
掻きまぜる	掻き雑ぜる
掻きみだれる	かきみだれる
掻きみだれる	掻き乱れる
掻きよせる	かきよせる
掻きよせる	掻き寄せる
掻きわける	かきわける
掻きわける	掻き分ける
揉みあげる	もみあげる
揉みあげる	揉み上げる
揉みいれる	もみいれる
揉みいれる	揉み入れる
揉みたてる	もみたてる
揉みたてる	揉み立てる
握りしめる	にぎりしめる
握りしめる	握り締める
握りつめる	にぎりつめる
握りつめる	握り詰める
揺すりあげる	ゆすりあげる
揺すりあげる	揺すり上げる
揺りあげる	ゆりあげる
揺りあげる	揺り上げる
揺りわける	ゆりわける
揺りわける	揺り分ける
搔きあげる	かきあげる
搔きあげる	搔き上げる
搔きあげる	搔き揚げる
搔きあつめる	かきあつめる
搔きあつめる	搔き集める
搔きいれる	かきいれる
搔きいれる	搔き入れる
搔ききえる	かききえる
搔ききえる	搔き消える
搔きくれる	かきくれる
搔きくれる	搔き暮れる
搔きたてる	かきたてる
搔きたてる	搔き立てる
搔きのける	かきのける
搔きのける	搔き退ける
搔きまぜる	かきまぜる
搔きまぜる	搔き混ぜる
搔きみだれる	かきみだれる
搔きみだれる	搔き乱れる
搔きよせる	かきよせる
搔きよせる	搔き寄せる
搔きわける	かきわける
搔きわける	搔き分ける
搗きまぜる	つきまぜる
搗きまぜる	搗き交ぜる
搗ちあげる	かちあげる
搗ちあげる	搗ち上げる
搾りあげる	しぼりあげる
搾りあげる	搾り上げる
摩りきれる	すりきれる
摩りきれる	摩り切れる
摺りあわせる	すりあわせる
摺りあわせる	摺り合せる
摺りあわせる	摺り合わせる
摺りいれる	すりいれる
摺りいれる	摺り入れる
摺りきれる	すりきれる
摺りきれる	摺り切れる
摺りつける	すりつける
摺りつける	摺り付ける
撚りあわせる	よりあわせる
撚りあわせる	撚り合わせる
撥ねあげる	はねあげる
撥ねあげる	撥ね上げる
撥ねかける	はねかける
撥ねかける	撥ね掛ける
撥ねつける	はねつける
撥ねつける	撥ね付ける
撥ねのける	はねのける
撥ねのける	撥ねのける
撥ねのける	撥ね除ける
撫であげる	なであげる
撫であげる	撫で上げる
撫でつける	なでつける
撫でつける	撫でつける
撫でつける	撫で付ける
撮りあげる	とりあげる
撮りあげる	撮り上げる
擦きれる	すりきれる
擦きれる	擦切れる
擦ぬける	すりぬける
擦ぬける	擦抜ける
擦りあげる	こすりあげる
擦りあげる	擦り上げる
擦りあわせる	すりあわせる
擦りあわせる	擦り合せる
擦りきれる	すりきれる
擦りきれる	擦り切れる
擦りこあげる	こすりあげる
擦りこあげる	擦り上げる
擦りつける	すりつける
擦りつける	擦り付ける
擦りなつける	なすりつける
擦りなつける	擦り付ける
擦りぬける	すりぬける
擦りぬける	擦り抜ける
擦りむける	すりむける
擦りむける	擦り剝ける
攻かける	せめかける
攻かける	攻掛ける
攻たてる	せめたてる
攻たてる	攻立てる
攻めかける	せめかける
攻めかける	攻め掛ける
攻めたてる	せめたてる
攻めたてる	攻め立てる
攻めつける	せめつける
攻めつける	攻め付ける
攻めよせる	せめよせる
攻めよせる	攻め寄せる
攻よせる	せめよせる
攻よせる	攻寄せる
放りあげる	ほうりあげる
放りあげる	放り上げる
放りつける	ほうりつける
放りつける	放り付ける
放りなげる	ほうりなげる
放りなげる	放り投げる
救いあげる	すくいあげる
救いあげる	救い上げる
教えそだてる	おしえそだてる
教えそだてる	教え育てる
散そめる	ちりそめる
散そめる	散初める
散みだれる	ちりみだれる
散みだれる	散乱れる
散りおちる	ちりおちる
散りおちる	散り落ちる
散りみだれる	ちりみだれる
散りみだれる	散り乱れる
数えあげる	かぞえあげる
数えあげる	数え上げる
数えいれる	かぞえいれる
数えいれる	数え入れる
数えたてる	かぞえたてる
数えたてる	数え立てる
敷きつめる	しきつめる
敷きつめる	敷き詰める
敷つめる	しきつめる
敷つめる	敷詰める
斬かける	きりかける
斬かける	斬掛ける
斬すてる	きりすてる
斬すてる	斬捨てる
斬ふせる	きりふせる
斬ふせる	斬伏せる
斬りかける	きりかける
斬りかける	斬り掛ける
斬りすてる	きりすてる
斬りすてる	斬り捨てる
斬りふせる	きりふせる
斬りふせる	斬り伏せる
方向づける	ほうこうづける
方向づける	方向付ける
旅なれる	たびなれる
旅なれる	旅慣れる
明けくれる	あけくれる
明けくれる	明け暮れる
明けそめる	あけそめる
明けそめる	明け初める
明けはなれる	あけはなれる
明けはなれる	明け離れる
明けひろげる	あけひろげる
明けひろげる	明け広げる
暮れおちる	くれおちる
暮れおちる	暮れ落ちる
暮れはてる	くれはてる
暮れはてる	暮れ果てる
暴きたてる	あばきたてる
暴きたてる	暴き立てる
書あげる	かきあげる
書あげる	書上げる
書あつめる	かきあつめる
書あつめる	書集める
書いれる	かきいれる
書いれる	書入れる
書おさめる	かきおさめる
書おさめる	書納める
書かえる	かきかえる
書かえる	書換える
書かえる	書替える
書きあげる	かきあげる
書きあげる	書き上げる
書きあつめる	かきあつめる
書きあつめる	書き集める
書きあらためる	かきあらためる
書きあらためる	書き改める
書きいれる	かきいれる
書きいれる	書き入れる
書きおおせる	かきおおせる
書きおおせる	書き果せる
書きおさめる	かきおさめる
書きおさめる	書き納める
書きかえる	かきかえる
書きかえる	書き換える
書きかえる	書き替える
書きくわえる	かきくわえる
書きくわえる	書き加える
書きしたためる	かきしたためる
書きしたためる	書き認める
書きすすめる	かきすすめる
書きすすめる	書き進める
書きすてる	かきすてる
書きすてる	書き捨てる
書きそえる	かきそえる
書きそえる	書き添える
書きそんじる	かきそんじる
書きそんじる	書き損じる
書きたてる	かきたてる
書きたてる	書き立てる
書きためる	かきためる
書きためる	書きためる
書きためる	書き溜める
書きつける	かきつける
書きつける	書き付ける
書きつたえる	かきつたえる
書きつたえる	書き伝える
書きつづける	かきつづける
書きつづける	書き続ける
書きつらねる	かきつらねる
書きつらねる	書き連ねる
書きとめる	かきとめる
書きとめる	書き留める
書きならべる	かきならべる
書きならべる	書き並べる
書きなれる	かきなれる
書きなれる	書き慣れる
書きなれる	書き馴れる
書きわける	かきわける
書きわける	書き分ける
書くわえる	かきくわえる
書くわえる	書加える
書すてる	かきすてる
書すてる	書捨てる
書そえる	かきそえる
書そえる	書添える
書たてる	かきたてる
書たてる	書立てる
書つたえる	かきつたえる
書つたえる	書伝える
書つらねる	かきつらねる
書つらねる	書連ねる
書とめる	かきとめる
書とめる	書留める
書なれる	かきなれる
書なれる	書慣れる
書わける	かきわける
書わける	書分ける
書わすれる	かきわすれる
書わすれる	書忘れる
書間ちがえる	かきまちがえる
書間ちがえる	書間違える
有りあわせる	ありあわせる
有りあわせる	有り合せる
有りあわせる	有り合わせる
有りえる	ありえる
有りえる	有り得る
有りふれる	ありふれる
有りふれる	有り触れる
望みみる	のぞみみる
望みみる	望み見る
朽ちおとろえる	くちおとろえる
朽ちおとろえる	朽ち衰える
朽ちはてる	くちはてる
朽ちはてる	朽ち果てる
朽はてる	くちはてる
朽はてる	朽果てる
来あわせる	きあわせる
来あわせる	来合わせる
来なれる	きなれる
来なれる	来慣れる
枯れおちる	かれおちる
枯れおちる	枯れ落ちる
枯れはてる	かれはてる
枯れはてる	枯れ果てる
染あげる	そめあげる
染あげる	染上げる
染かえる	そめかえる
染かえる	染替える
染でる	しみでる
染でる	染出る
染みじみる	じみる
染みじみる	染みる
染みつける	しみつける
染みつける	染み付ける
染みでる	しみでる
染みでる	染み出る
染めあげる	そめあげる
染めあげる	染め上げる
染めかえる	そめかえる
染めかえる	染め変える
染めかえる	染め替える
染めつける	そめつける
染めつける	染め付ける
染めわける	そめわける
染めわける	染め分ける
染わける	そめわける
染わける	染分ける
棲みわける	すみわける
棲みわける	棲み分ける
植えかえる	うえかえる
植えかえる	植え換える
植えかえる	植え替える
植えつける	うえつける
植えつける	植え付ける
植かえる	うえかえる
植かえる	植換える
植かえる	植替える
構いつける	かまいつける
構いつける	構い付ける
歌いあげる	うたいあげる
歌いあげる	歌い上げる
歌いおさめる	うたいおさめる
歌いおさめる	歌い納める
歌いかける	うたいかける
歌いかける	歌い掛ける
歩みでる	あゆみでる
歩みでる	歩み出る
死におくれる	しにおくれる
死におくれる	死に後れる
死におくれる	死に遅れる
死にかける	しにかける
死にかける	死に懸ける
死にかける	死に掛ける
死にきれる	しにきれる
死にきれる	死に切れる
死にたえる	しにたえる
死にたえる	死に絶える
死にはてる	しにはてる
死にはてる	死に果てる
死にわかれる	しにわかれる
死にわかれる	死に別れる
殴りつける	なぐりつける
殴りつける	殴りつける
殴りつける	殴り付ける
比べあわせる	くらべあわせる
比べあわせる	比べ合わせる
汲みあげる	くみあげる
汲みあげる	汲み上げる
汲みいれる	くみいれる
汲みいれる	汲み入れる
汲みわける	くみわける
汲みわける	汲み分ける
決めつける	きめつける
決めつける	決め付ける
決定づける	けっていづける
決定づける	決定付ける
泊まりあわせる	とまりあわせる
泊まりあわせる	泊まり合わせる
泣きくずれる	なきくずれる
泣きくずれる	泣き崩れる
泣きたてる	なきたてる
泣きたてる	泣き立てる
泣きぬれる	なきぬれる
泣きぬれる	泣き濡れる
泣きわかれる	なきわかれる
泣きわかれる	泣き別れる
泣くずれる	なきくずれる
泣くずれる	泣崩れる
泣たてる	なきたてる
泣たてる	泣立てる
泣わかれる	なきわかれる
泣わかれる	泣別れる
注ぎいれる	そそぎいれる
注ぎいれる	注ぎ入れる
注ぎかける	そそぎかける
注ぎかける	注ぎ掛ける
泳ぎでる	およぎでる
泳ぎでる	泳ぎ出る
洗いあげる	あらいあげる
洗いあげる	洗い上げる
洗いきよめる	あらいきよめる
洗いきよめる	洗い清める
洗いたてる	あらいたてる
洗いたてる	洗い立てる
流しいれる	ながしいれる
流しいれる	流し入れる
流れおちる	ながれおちる
流れおちる	流れ落ちる
流れでる	ながれでる
流れでる	流れ出る
浮かびでる	うかびでる
浮かびでる	浮かび出る
浮かれでる	うかれでる
浮かれでる	浮かれ出る
浮きでる	うきでる
浮きでる	浮き出る
浮でる	うきでる
浮でる	浮出る
浮びでる	うかびでる
浮びでる	浮び出る
浮れでる	うかれでる
浮れでる	浮れ出る
浴びせかける	あびせかける
浴びせかける	浴びせ掛ける
浸しいれる	ひたしいれる
浸しいれる	浸し入れる
消えうせる	きえうせる
消えうせる	消え失せる
消えはてる	きえはてる
消えはてる	消え果てる
消しとめる	けしとめる
消しとめる	消し止める
涌きでる	わきでる
涌きでる	涌き出る
淘りわける	ゆりわける
淘りわける	淘り分ける
混ぜあわせる	まぜあわせる
混ぜあわせる	混ぜ合せる
混ぜあわせる	混ぜ合わせる
混ぜいれる	まぜいれる
混ぜいれる	混ぜ入れる
添いとげる	そいとげる
添いとげる	添い遂げる
添とげる	そいとげる
添とげる	添遂げる
湧きでる	わきでる
湧きでる	湧き出る
満たりる	みちたりる
満たりる	満足りる
満ちあふれる	みちあふれる
満ちあふれる	満ちあふれる
満ちあふれる	満ち溢れる
満ちたりる	みちたりる
満ちたりる	満ち足りる
溢れでる	あふれでる
溢れでる	溢れ出る
溶かしいれる	とかしいれる
溶かしいれる	溶かし入れる
溶きいれる	ときいれる
溶きいれる	溶き入れる
溶けでる	とけでる
溶けでる	溶け出る
滑りおちる	すべりおちる
滑りおちる	滑り落ちる
滑りおりる	すべりおりる
滑りおりる	滑り降りる
滑りでる	すべりでる
滑りでる	滑り出る
滲みしみる	しみる
滲みしみる	滲みる
滲みでる	にじみでる
滲みでる	滲み出る
滴りおちる	したたりおちる
滴りおちる	滴り落ちる
漂いでる	ただよいでる
漂いでる	漂い出る
漏れおちる	もれおちる
漏れおちる	漏れ落ちる
漏れきこえる	もれきこえる
漏れきこえる	漏れ聞こえる
漕ぎいれる	こぎいれる
漕ぎいれる	漕ぎ入れる
漕ぎつける	こぎつける
漕ぎつける	漕ぎ着ける
漕ぎでる	こぎでる
漕ぎでる	漕ぎ出る
漕ぎぬける	こぎぬける
漕ぎぬける	漕ぎ抜ける
漕ぎみる	こぎみる
漕ぎみる	漕ぎ回る
漕ぎよせる	こぎよせる
漕ぎよせる	漕ぎ寄せる
潜りぬける	くぐりぬける
潜りぬける	潜り抜ける
炊きあげる	たきあげる
炊きあげる	炊き上げる
炒めあげる	いためあげる
炒めあげる	炒め上げる
炒りつける	いりつける
炒りつける	炒り付ける
為しとげる	なしとげる
為しとげる	為し遂げる
為ちがえる	しちがえる
為ちがえる	為違える
為とげる	しとげる
為とげる	為遂げる
為とめる	しとめる
為とめる	為留める
為なれる	しなれる
為なれる	為慣れる
為はてる	しはてる
為はてる	為果てる
焚きしめる	たきしめる
焚きしめる	焚き染める
焚きつける	たきつける
焚きつける	焚き付ける
焼あげる	やきあげる
焼あげる	焼上げる
焼きあげる	やきあげる
焼きあげる	焼き上げる
焼きすぎる	やきすぎる
焼きすぎる	焼き過ぎる
焼きすてる	やきすてる
焼きすてる	焼き捨てる
焼きつける	やきつける
焼きつける	焼き付ける
焼けうせる	やけうせる
焼けうせる	焼け失せる
焼けおちる	やけおちる
焼けおちる	焼け落ちる
焼けきれる	やけきれる
焼けきれる	焼け切れる
焼けこげる	やけこげる
焼けこげる	焼け焦げる
焼けただれる	やけただれる
焼けただれる	焼け爛れる
焼けだされる	やけだされる
焼けだされる	焼け出される
焼すぎる	やきすぎる
焼すぎる	焼過ぎる
焼すてる	やきすてる
焼すてる	焼捨てる
煉りあげる	ねりあげる
煉りあげる	煉り上げる
煉りあわせる	ねりあわせる
煉りあわせる	煉り合わせる
煉りかためる	ねりかためる
煉りかためる	煉り固める
煎じつめる	せんじつめる
煎じつめる	煎じ詰める
煎りあげる	いりあげる
煎りあげる	煎り上げる
煎りつける	いりつける
煎りつける	煎り付ける
照あわせる	てりあわせる
照あわせる	照合わせる
照らしあわせる	てらしあわせる
照らしあわせる	照らし合せる
照らしあわせる	照らし合わせる
照らしつける	てらしつける
照らしつける	照らし付ける
照りあわせる	てりあわせる
照りあわせる	照り合せる
照りあわせる	照り合わせる
照りつける	てりつける
照りつける	照り付ける
照りはえる	てりはえる
照りはえる	照り映える
煮あげる	にあげる
煮あげる	煮上げる
煮あわせる	にあわせる
煮あわせる	煮合せる
煮あわせる	煮合わせる
煮えこぼれる	にえこぼれる
煮えこぼれる	煮え零れる
煮くずれる	にくずれる
煮くずれる	煮崩れる
煮こぼれる	にこぼれる
煮こぼれる	煮こぼれる
煮こぼれる	煮零れる
煮しめる	にしめる
煮しめる	煮染める
煮たたせる	にたたせる
煮たたせる	煮立たせる
煮たてる	にたてる
煮たてる	煮立てる
煮つける	につける
煮つける	煮付ける
煮つめる	につめる
煮つめる	煮詰める
煮ふくめる	にふくめる
煮ふくめる	煮含める
煽ぎたてる	あおぎたてる
煽ぎたてる	煽ぎ立てる
煽りたてる	あおりたてる
煽りたてる	煽り立てる
煽りつける	あおりつける
煽りつける	煽り付ける
燃えおちる	もえおちる
燃えおちる	燃え落ちる
燃えつきる	もえつきる
燃えつきる	燃え尽きる
燃やしつける	もやしつける
燃やしつける	燃やし付ける
片づける	かたづける
片づける	片付ける
片よせる	かたよせる
片よせる	片寄せる
物たりる	ものたりる
物たりる	物足りる
物なれる	ものなれる
物なれる	物慣れる
物みる	ものみる
物みる	物見る
特徴づける	とくちょうづける
特徴づける	特徴付ける
特色づける	とくしょくづける
特色づける	特色付ける
狙いさだめる	ねらいさだめる
狙いさだめる	狙い定める
現れでる	あらわれでる
現れでる	現れ出る
現れる	あらわれる
現れる	現れる（現われる）
理屈づける	りくつづける
理屈づける	理屈付ける
生えでる	はえでる
生えでる	生え出る
生きながらえる	いきながらえる
生きながらえる	生き存える
生きながらえる	生き長らえる
生きのびる	いきのびる
生きのびる	生き延びる
生きわかれる	いきわかれる
生きわかれる	生き別れる
生けかえる	いけかえる
生けかえる	生け替える
生のびる	いきのびる
生のびる	生延びる
生まれあわせる	うまれあわせる
生まれあわせる	生まれ合せる
生まれあわせる	生まれ合わせる
生まれおちる	うまれおちる
生まれおちる	生まれ落ちる
生まれでる	うまれでる
生まれでる	生まれ出る
生みつける	うみつける
生みつける	生み付ける
生みわける	うみわける
生みわける	生み分ける
生れあわせる	うまれあわせる
生れあわせる	生れ合わせる
生れおちる	うまれおちる
生れおちる	生れ落ちる
生れでる	うまれでる
生れでる	生れ出る
生わかれる	いきわかれる
生わかれる	生別れる
申あげる	もうしあげる
申あげる	申上げる
申あわせる	もうしあわせる
申あわせる	申合わせる
申いれる	もうしいれる
申いれる	申入れる
申うける	もうしうける
申うける	申受ける
申おくれる	もうしおくれる
申おくれる	申遅れる
申きかせる	もうしきかせる
申きかせる	申聞かせる
申しあげる	もうしあげる
申しあげる	申し上げる
申しあわせる	もうしあわせる
申しあわせる	申し合せる
申しあわせる	申し合わせる
申しいでる	もうしいでる
申しいでる	申し出でる
申しいれる	もうしいれる
申しいれる	申し入れる
申しうける	もうしうける
申しうける	申し受ける
申しおくれる	もうしおくれる
申しおくれる	申し遅れる
申しかねる	もうしかねる
申しかねる	申し兼ねる
申しきかせる	もうしきかせる
申しきかせる	申し聞かせる
申しきける	もうしきける
申しきける	申し聞ける
申しそえる	もうしそえる
申しそえる	申し添える
申したてる	もうしたてる
申したてる	申し立てる
申しつける	もうしつける
申しつける	申し付ける
申しつたえる	もうしつたえる
申しつたえる	申し伝える
申しでる	もうしでる
申しでる	申し出る
申しのべる	もうしのべる
申しのべる	申し述べる
申そえる	もうしそえる
申そえる	申添える
申たてる	もうしたてる
申たてる	申立てる
申つたえる	もうしつたえる
申つたえる	申伝える
申でる	もうしでる
申でる	申出る
申のべる	もうしのべる
申のべる	申述べる
留めつける	とめつける
留めつける	留め付ける
畳みあげる	たたみあげる
畳みあげる	畳み上げる
畳みかける	たたみかける
畳みかける	畳み掛ける
疲れはてる	つかれはてる
疲れはてる	疲れ果てる
痛めつける	いためつける
痛めつける	痛め付ける
痛めやめる	やめる
痛めやめる	痛める
痩せおとろえる	やせおとろえる
痩せおとろえる	痩せ衰える
登りつめる	のぼりつめる
登りつめる	登り詰める
盗みみる	ぬすみみる
盗みみる	盗み見る
盛あげる	もりあげる
盛あげる	盛上げる
盛あわせる	もりあわせる
盛あわせる	盛合わせる
盛さげる	もりさげる
盛さげる	盛下げる
盛たてる	もりたてる
盛たてる	盛立てる
盛りあげる	もりあげる
盛りあげる	盛り上げる
盛りあわせる	もりあわせる
盛りあわせる	盛り合せる
盛りあわせる	盛り合わせる
盛りいれる	もりいれる
盛りいれる	盛り入れる
盛りさげる	もりさげる
盛りさげる	盛り下げる
盛りたてる	もりたてる
盛りたてる	盛り立てる
盛りつける	もりつける
盛りつける	盛り付ける
目なれる	めなれる
目なれる	目慣れる
相はてる	あいはてる
相はてる	相果てる
相みる	あいみる
相みる	相見る
着かえる	きかえる
着かえる	きがえる
着かえる	着換える
着かえる	着替える
着くずれる	きくずれる
着くずれる	着崩れる
着すてる	きすてる
着すてる	着捨てる
着すてる	着棄てる
着せかえる	きせかえる
着せかえる	着せ替える
着せかける	きせかける
着せかける	着せ掛ける
着せつける	きせつける
着せつける	着せ付ける
着つける	きつける
着つける	つける
着つける	着ける
着つける	着付ける
着なれる	きなれる
着なれる	着慣れる
着なれる	着馴れる
着ぶくれる	きぶくれる
着ぶくれる	着脹れる
着ぶくれる	着膨れる
睨みあわせる	にらみあわせる
睨みあわせる	睨み合わせる
睨みすえる	にらみすえる
睨みすえる	睨み据える
睨めつける	ねめつける
睨めつける	睨め付ける
知そめる	しりそめる
知そめる	知初める
研あげる	とぎあげる
研あげる	研上げる
研ぎあげる	とぎあげる
研ぎあげる	研ぎ上げる
磨きあげる	みがきあげる
磨きあげる	磨き上げる
磨きたてる	みがきたてる
磨きたてる	磨き立てる
示しあたえる	しめしあたえる
示しあたえる	示し与える
示しあわせる	しめしあわせる
示しあわせる	示し合せる
示しあわせる	示し合わせる
祈りあげる	いのりあげる
祈りあげる	祈り上げる
祓いきよめる	はらいきよめる
祓いきよめる	祓い清める
祭りあげる	まつりあげる
祭りあげる	祭り上げる
移しいれる	うつしいれる
移しいれる	移し入れる
移しうえる	うつしうえる
移しうえる	移し植える
移しかえる	うつしかえる
移しかえる	移し替える
積あげる	つみあげる
積あげる	積上げる
積かえる	つみかえる
積かえる	積換える
積かえる	積替える
積かさねる	つみかさねる
積かさねる	積重ねる
積たてる	つみたてる
積たてる	積立てる
積みあげる	つみあげる
積みあげる	積み上げる
積みいれる	つみいれる
積みいれる	積み入れる
積みかえる	つみかえる
積みかえる	積み換える
積みかえる	積み替える
積みかさねる	つみかさねる
積みかさねる	積み重ねる
積みたてる	つみたてる
積みたてる	積み立てる
穿きちがえる	はきちがえる
穿きちがえる	穿き違える
突あげる	つきあげる
突あげる	突上げる
突あてる	つきあてる
突あてる	突当てる
突あわせる	つきあわせる
突あわせる	突合わせる
突いれる	つきいれる
突いれる	突入れる
突かける	つきかける
突かける	突掛ける
突かためる	つきかためる
突かためる	突固める
突きあける	つきあける
突きあける	突き開ける
突きあげる	つきあげる
突きあげる	突き上げる
突きあてる	つきあてる
突きあてる	突き当てる
突きあわせる	つきあわせる
突きあわせる	突き合せる
突きあわせる	突き合わせる
突きいれる	つきいれる
突きいれる	突き入れる
突きかける	つきかける
突きかける	突き掛ける
突きかためる	つきかためる
突きかためる	突き固める
突きすえる	つきすえる
突きすえる	突き据える
突きたてる	つきたてる
突きたてる	突き立てる
突きつける	つきつける
突きつける	突き付ける
突きつめる	つきつめる
突きつめる	突き詰める
突きでる	つきでる
突きでる	突き出る
突きとめる	つきとめる
突きとめる	突き止める
突きぬける	つきぬける
突きぬける	突き抜ける
突きのける	つきのける
突きのける	突き退ける
突きのける	突き除ける
突すえる	つきすえる
突すえる	突据える
突たてる	つきたてる
突たてる	突立てる
突っかける	つっかける
突っかける	突っ掛ける
突っくるめる	つっくるめる
突っくるめる	突っ包める
突っくるめる	突っ含める
突っくるめる	突っ括める
突ったてる	つったてる
突ったてる	突っ立てる
突っはねる	つっぱねる
突っはねる	突っぱねる
突っぱねる	つっぱねる
突っぱねる	突っ撥ねる
突つめる	つきつめる
突つめる	突詰める
突でる	つきでる
突でる	突出る
突ぬける	つきぬける
突ぬける	突抜ける
立あげる	たちあげる
立あげる	立上げる
立おくれる	たちおくれる
立おくれる	立遅れる
立かえる	たてかえる
立かえる	立替える
立かける	たてかける
立かける	立掛ける
立こえる	たちこえる
立こえる	立越える
立こめる	たちこめる
立こめる	たてこめる
立こめる	立籠める
立こめる	立込める
立ちあげる	たちあげる
立ちあげる	立ち上げる
立ちあらわれる	たちあらわれる
立ちあらわれる	立ち顕れる
立ちいる	たちいる
立ちいる	立ち居る
立ちおくれる	たちおくれる
立ちおくれる	立ち後れる
立ちおくれる	立ち遅れる
立ちがれる	たちがれる
立ちがれる	立ち枯れる
立ちきれる	たちきれる
立ちきれる	立ち切れる
立ちくたびれる	たちくたびれる
立ちくたびれる	立ち草臥れる
立ちこえる	たちこえる
立ちこえる	立ち越える
立ちこめる	たちこめる
立ちこめる	立ち籠める
立ちこめる	立ち込める
立ちつづける	たちつづける
立ちつづける	立ち続ける
立ちみる	たちみる
立ちみる	立ち見る
立ちわかれる	たちわかれる
立ちわかれる	立ち別れる
立てかえる	たてかえる
立てかえる	立て替える
立てかける	たてかける
立てかける	立て懸ける
立てかける	立て掛ける
立てこめる	たてこめる
立てこめる	立て籠める
立てこめる	立て込める
立てつける	たてつける
立てつける	立て付ける
立わかれる	たちわかれる
立わかれる	立別れる
競あげる	せりあげる
競あげる	競上げる
競まける	せりまける
競まける	競負ける
競りあげる	せりあげる
競りあげる	競り上げる
競りまける	せりまける
競りまける	競り負ける
笑いかける	わらいかける
笑いかける	笑い掛ける
笑いきょうじる	わらいきょうじる
笑いきょうじる	笑い興じる
笑いくずれる	わらいくずれる
笑いくずれる	笑い崩れる
笑いこける	わらいこける
笑いこける	笑いこける
笑いこける	笑い転ける
笑いころげる	わらいころげる
笑いころげる	笑いころげる
笑いころげる	笑い転げる
笑みくずれる	えみくずれる
笑みくずれる	笑み崩れる
箝げかえる	すげかえる
箝げかえる	箝げ替える
築きあげる	つきあげる
築きあげる	築き上げる
築きたてる	つきたてる
築きたてる	築き立てる
篩いわける	ふるいわける
篩いわける	篩い分ける
紐づける	ひもづける
紐づける	紐付ける
組あげる	くみあげる
組あげる	組上げる
組あわせる	くみあわせる
組あわせる	組合わせる
組いれる	くみいれる
組いれる	組入れる
組かえる	くみかえる
組かえる	組換える
組かえる	組替える
組たてる	くみたてる
組たてる	組立てる
組ちがえる	くみちがえる
組ちがえる	組違える
組とめる	くみとめる
組とめる	組留める
組ふせる	くみふせる
組ふせる	組伏せる
組みあげる	くみあげる
組みあげる	組み上げる
組みあわせる	くみあわせる
組みあわせる	組み合せる
組みあわせる	組み合わせる
組みいれる	くみいれる
組みいれる	組み入れる
組みかえる	くみかえる
組みかえる	組み換える
組みかえる	組み替える
組みたてる	くみたてる
組みたてる	組み立てる
組みちがえる	くみちがえる
組みちがえる	組み違える
組みふせる	くみふせる
組みふせる	組み伏せる
組みわける	くみわける
組みわける	組み分ける
結あげる	ゆいあげる
結あげる	結上げる
結いあげる	ゆいあげる
結いあげる	結い上げる
結いからげる	ゆいからげる
結いからげる	結い絡げる
結いつける	ゆいつける
結いつける	結い付ける
結びあげる	むすびあげる
結びあげる	結び上げる
結びあわせる	むすびあわせる
結びあわせる	結び合せる
結びあわせる	結び合わせる
結びつける	むすびつける
結びつける	結び付ける
結わえあげる	ゆわえあげる
結わえあげる	結わえ上げる
結わえつける	ゆわえつける
結わえつける	結わえ付ける
結論づける	けつろんづける
結論づける	結論付ける
絞りあげる	しぼりあげる
絞りあげる	絞り上げる
絞りいれる	しぼりいれる
絞りいれる	絞り入れる
絡みつける	からみつける
絡みつける	絡み付ける
絶えはてる	たえはてる
絶えはてる	絶え果てる
絶はてる	たえはてる
絶はてる	絶果てる
継あわせる	つぎあわせる
継あわせる	継合わせる
継ぎあわせる	つぎあわせる
継ぎあわせる	継ぎ合せる
継ぎあわせる	継ぎ合わせる
継ぎたてる	つぎたてる
継ぎたてる	継ぎ立てる
継たてる	つぎたてる
継たてる	継立てる
綯いまぜる	ないまぜる
綯いまぜる	綯い交ぜる
綴じあわせる	とじあわせる
綴じあわせる	綴じ合せる
綴じあわせる	綴じ合わせる
綴じつける	とじつける
綴じつける	綴じ付ける
綴りあわせる	つづりあわせる
綴りあわせる	綴り合わせる
締あげる	しめあげる
締あげる	締上げる
締めあげる	しめあげる
締めあげる	締め上げる
締めつける	しめつける
締めつける	締めつける
締めつける	締め付ける
締めよせる	しめよせる
締めよせる	締め寄せる
締よせる	しめよせる
締よせる	締寄せる
編あげる	あみあげる
編あげる	編上げる
編たてる	あみたてる
編たてる	編立てる
編みあげる	あみあげる
編みあげる	編み上げる
編みあわせる	あみあわせる
編みあわせる	編み合わせる
編みいれる	あみいれる
編みいれる	編み入れる
編みたてる	あみたてる
編みたてる	編み立てる
編みつける	あみつける
編みつける	編み付ける
練あげる	ねりあげる
練あげる	練上げる
練あわせる	ねりあわせる
練あわせる	練合わせる
練かためる	ねりかためる
練かためる	練固める
練りあげる	ねりあげる
練りあげる	練り上げる
練りあわせる	ねりあわせる
練りあわせる	練り合せる
練りあわせる	練り合わせる
練りかためる	ねりかためる
練りかためる	練り固める
縁づける	えんづける
縁づける	縁付ける
縒りあげる	よりあげる
縒りあげる	縒り上げる
縒りあわせる	よりあわせる
縒りあわせる	縒り合せる
縒りあわせる	縒り合わせる
縛りあげる	しばりあげる
縛りあげる	縛り上げる
縛りつける	しばりつける
縛りつける	縛り付ける
縫あげる	ぬいあげる
縫あげる	縫上げる
縫あわせる	ぬいあわせる
縫あわせる	縫合わせる
縫いあげる	ぬいあげる
縫いあげる	縫い上げる
縫いあわせる	ぬいあわせる
縫いあわせる	縫い合せる
縫いあわせる	縫い合わせる
縫いこめる	ぬいこめる
縫いこめる	縫い込める
縫いつける	ぬいつける
縫いつける	縫い付ける
縫いれる	ぬいいれる
縫いれる	縫入れる
繋ぎあわせる	つなぎあわせる
繋ぎあわせる	繋ぎ合わせる
繋ぎとめる	つなぎとめる
繋ぎとめる	繋ぎ止める
織まぜる	おりまぜる
織まぜる	織交ぜる
織りあげる	おりあげる
織りあげる	織り上げる
織りまぜる	おりまぜる
織りまぜる	織り交ぜる
繰あげる	くりあげる
繰あげる	繰上げる
繰あわせる	くりあわせる
繰あわせる	繰合わせる
繰いれる	くりいれる
繰いれる	繰入れる
繰かえる	くりかえる
繰かえる	繰替える
繰さげる	くりさげる
繰さげる	繰下げる
繰ひろげる	くりひろげる
繰ひろげる	繰広げる
繰よせる	くりよせる
繰よせる	繰寄せる
繰りあげる	くりあげる
繰りあげる	繰り上げる
繰りあわせる	くりあわせる
繰りあわせる	繰り合せる
繰りあわせる	繰り合わせる
繰りいれる	くりいれる
繰りいれる	繰り入れる
繰りかえる	くりかえる
繰りかえる	繰り替える
繰りさげる	くりさげる
繰りさげる	繰り下げる
繰りのべる	くりのべる
繰りのべる	繰り延べる
繰りひろげる	くりひろげる
繰りひろげる	繰り広げる
繰りよせる	くりよせる
繰りよせる	繰り寄せる
纏めあげる	まとめあげる
纏めあげる	纏め上げる
置かえる	おきかえる
置かえる	置換える
置かえる	置替える
置きかえる	おきかえる
置きかえる	置き換える
置きかえる	置き替える
置きすてる	おきすてる
置きすてる	置き捨てる
置きわすれる	おきわすれる
置きわすれる	置き忘れる
置すてる	おきすてる
置すてる	置捨てる
置わすれる	おきわすれる
置わすれる	置忘れる
罷りでる	まかりでる
罷りでる	罷り出る
義務づける	ぎむづける
義務づける	義務付ける
習いおぼえる	ならいおぼえる
習いおぼえる	習い覚える
老いはてる	おいはてる
老いはてる	老い果てる
老はてる	おいはてる
老はてる	老果てる
考えあわせる	かんがえあわせる
考えあわせる	考え合せる
考えあわせる	考え合わせる
耳なれる	みみなれる
耳なれる	耳慣れる
聞あわせる	ききあわせる
聞あわせる	聞合わせる
聞いれる	ききいれる
聞いれる	聞入れる
聞おぼえる	ききおぼえる
聞おぼえる	聞覚える
聞きあきる	ききあきる
聞きあきる	聞き飽きる
聞きあわせる	ききあわせる
聞きあわせる	聞き合せる
聞きあわせる	聞き合わせる
聞きいれる	ききいれる
聞きいれる	聞き入れる
聞きおぼえる	ききおぼえる
聞きおぼえる	聞き覚える
聞きくらべる	ききくらべる
聞きくらべる	聞き比べる
聞きさだめる	ききさだめる
聞きさだめる	聞き定める
聞きしめる	ききしめる
聞きしめる	聞き占める
聞きすてる	ききすてる
聞きすてる	聞き捨てる
聞きちがえる	ききちがえる
聞きちがえる	聞き違える
聞きつける	ききつける
聞きつける	聞き付ける
聞きつたえる	ききつたえる
聞きつたえる	聞き伝える
聞きとがめる	ききとがめる
聞きとがめる	聞きとがめる
聞きとがめる	聞き咎める
聞きとどける	ききとどける
聞きとどける	聞き届ける
聞きとめる	ききとめる
聞きとめる	聞き留める
聞きとれる	ききとれる
聞きとれる	聞き蕩れる
聞きなれる	ききなれる
聞きなれる	聞き慣れる
聞きなれる	聞き馴れる
聞きほれる	ききほれる
聞きほれる	聞き惚れる
聞きわける	ききわける
聞きわける	聞き分ける
聞きわすれる	ききわすれる
聞きわすれる	聞き忘れる
聞さだめる	ききさだめる
聞さだめる	聞定める
聞すてる	ききすてる
聞すてる	聞捨てる
聞ちがえる	ききちがえる
聞ちがえる	聞違える
聞つたえる	ききつたえる
聞つたえる	聞伝える
聞とどける	ききとどける
聞とどける	聞届ける
聞とめる	ききとめる
聞とめる	聞留める
聞なれる	ききなれる
聞なれる	聞慣れる
聞はてる	ききはてる
聞はてる	聞果てる
聞わける	ききわける
聞わける	聞分ける
聞わすれる	ききわすれる
聞わすれる	聞忘れる
聴きほれる	ききほれる
聴きほれる	聴き惚れる
職すぎる	しょくすぎる
職すぎる	職過ぎる
育てあげる	そだてあげる
育てあげる	育て上げる
脅しつける	おどしつける
脅しつける	脅しつける
脅しつける	脅し付ける
脱かえる	ぬぎかえる
脱かえる	脱換える
脱かける	ぬぎかける
脱かける	脱掛ける
脱ぎかける	ぬぎかける
脱ぎかける	脱ぎ掛ける
脱ぎすてる	ぬぎすてる
脱ぎすてる	脱ぎ捨てる
脱けでる	ぬけでる
脱けでる	脱け出る
脱げおちる	ぬげおちる
脱げおちる	脱げ落ちる
脱すてる	ぬぎすてる
脱すてる	脱捨てる
腑ぬける	ふぬける
腑ぬける	腑抜ける
腰かける	こしかける
腰かける	腰掛ける
舁きあげる	かきあげる
舁きあげる	舁き上げる
舁きいれる	かきいれる
舁きいれる	舁き入れる
舂きまぜる	つきまぜる
舂きまぜる	舂き交ぜる
舞いあげる	まいあげる
舞いあげる	舞い上げる
舞いおさめる	まいおさめる
舞いおさめる	舞い納める
舞いおちる	まいおちる
舞いおちる	舞い落ちる
舞いおりる	まいおりる
舞いおりる	舞い降りる
舞いでる	まいでる
舞いでる	舞い出る
舞おさめる	まいおさめる
舞おさめる	舞納める
舞おちる	まいおちる
舞おちる	舞落ちる
舞おりる	まいおりる
舞おりる	舞降りる
色づける	いろづける
色づける	色付ける
茹であげる	うであげる
茹であげる	ゆであげる
茹であげる	茹で上げる
茹でこぼれる	ゆでこぼれる
茹でこぼれる	茹でこぼれる
荒れはてる	あれはてる
荒れはてる	荒れ果てる
萌えでる	もえでる
萌えでる	萌え出る
落しいれる	おとしいれる
落しいれる	落し入れる
落ちいる	おちいる
落ちいる	落ち居る
落ちこぼれる	おちこぼれる
落ちこぼれる	落ちこぼれる
落ちつける	おちつける
落ちつける	落ち付ける
落ちつける	落ち着ける
落ちのびる	おちのびる
落ちのびる	落ち延びる
落つける	おちつける
落つける	落着ける
落としいれる	おとしいれる
落としいれる	落とし入れる
落のびる	おちのびる
落のびる	落延びる
葺きかえる	ふきかえる
葺きかえる	葺き替える
蒸しあげる	むしあげる
蒸しあげる	蒸し上げる
蔵いわすれる	しまいわすれる
蔵いわすれる	蔵い忘れる
薙ぎたてる	なぎたてる
薙ぎたてる	薙ぎ立てる
薙ぎふせる	なぎふせる
薙ぎふせる	薙ぎ伏せる
薫きこめる	たきこめる
薫きこめる	薫き込める
薫きしめる	たきしめる
薫きしめる	薫き染める
行あわせる	ゆきあわせる
行あわせる	行合わせる
行きあわせる	いきあわせる
行きあわせる	ゆきあわせる
行きあわせる	行き合せる
行きあわせる	行き合わせる
行きくれる	ゆきくれる
行きくれる	行き暮れる
行きすぎる	ゆきすぎる
行きすぎる	行き過ぎる
行きちがえる	ゆきちがえる
行きちがえる	行き違える
行きつける	ゆきつける
行きつける	行き付ける
行きめぐる	ゆきめぐる
行きめぐる	行き廻る
行きわかれる	ゆきわかれる
行きわかれる	行き別れる
行くれる	ゆきくれる
行くれる	行暮れる
行すぎる	ゆきすぎる
行すぎる	行過ぎる
行ちがえる	ゆきちがえる
行ちがえる	行違える
行つめる	ゆきつめる
行つめる	行詰める
行わかれる	ゆきわかれる
行わかれる	行別れる
衝きあげる	つきあげる
衝きあげる	衝き上げる
裁あわせる	たちあわせる
裁あわせる	裁合わせる
裁ちあわせる	たちあわせる
裁ちあわせる	裁ち合わせる
裏づける	うらづける
裏づける	裏付ける
褒めあげる	ほめあげる
褒めあげる	褒め上げる
褒めたたえる	ほめたたえる
褒めたたえる	褒め称える
褒めたてる	ほめたてる
褒めたてる	褒め立てる
覆いかぶせる	おおいかぶせる
覆いかぶせる	覆いかぶせる
覆いかぶせる	覆い被せる
見あきる	みあきる
見あきる	見飽きる
見あげる	みあげる
見あげる	見上げる
見あわせる	みあわせる
見あわせる	見合せる
見あわせる	見合わせる
見うける	みうける
見うける	見受ける
見おぼえる	みおぼえる
見おぼえる	見覚える
見かえる	みかえる
見かえる	見変える
見かえる	見替える
見かける	みかける
見かける	見掛ける
見かねる	みかねる
見かねる	見兼ねる
見きれる	みきれる
見きれる	見切れる
見きわめる	みきわめる
見きわめる	見極める
見くらべる	みくらべる
見くらべる	見比べる
見くらべる	見較べる
見さげはてる	みさげはてる
見さげはてる	見下げ果てる
見さげる	みさげる
見さげる	見下げる
見さだめる	みさだめる
見さだめる	見定める
見すえる	みすえる
見すえる	見据える
見すてる	みすてる
見すてる	見捨てる
見すてる	見棄てる
見せかける	みせかける
見せかける	見せ掛ける
見せつける	みせつける
見せつける	見せ付ける
見そめる	みそめる
見そめる	見初める
見そんじる	みそんじる
見そんじる	見損じる
見たてる	みたてる
見たてる	見立てる
見ちがえる	みちがえる
見ちがえる	見違える
見つける	みつける
見つける	見付ける
見つめる	みつめる
見つめる	見詰める
見とがめる	みとがめる
見とがめる	見とがめる
見とがめる	見咎める
見とどける	みとどける
見とどける	見届ける
見とれる	みとれる
見とれる	見とれる
見とれる	見蕩れる
見なれる	みなれる
見なれる	見慣れる
見なれる	見馴れる
見はぐれる	みはぐれる
見はぐれる	見逸れる
見はてる	みはてる
見はてる	見果てる
見ほれる	みほれる
見ほれる	見惚れる
見まちがえる	みまちがえる
見まちがえる	見間違える
見わける	みわける
見わける	見分ける
見わすれる	みわすれる
見わすれる	見忘れる
見下げはてる	みさげはてる
見下げはてる	見下げ果てる
見間ちがえる	みまちがえる
見間ちがえる	見間違える
覗きみる	のぞきみる
覗きみる	覗き見る
言あてる	いいあてる
言あてる	言当てる
言あわせる	いいあわせる
言あわせる	言合わせる
言いあてる	いいあてる
言いあてる	言い当てる
言いあわせる	いいあわせる
言いあわせる	言い合せる
言いあわせる	言い合わせる
言いいれる	いいいれる
言いいれる	言い入れる
言いおくれる	いいおくれる
言いおくれる	言い遅れる
言いかえる	いいかえる
言いかえる	言い換える
言いかえる	言い替える
言いかける	いいかける
言いかける	言い掛ける
言いかためる	いいかためる
言いかためる	言い固める
言いかねる	いいかねる
言いかねる	言い兼ねる
言いかぶせる	いいかぶせる
言いかぶせる	言い被せる
言いきかせる	いいきかせる
言いきかせる	言い聞かせる
言いくるめる	いいくるめる
言いくるめる	言いくるめる
言いくるめる	言い包める
言いくろめる	いいくろめる
言いくろめる	言い黒める
言いこしらえる	いいこしらえる
言いこしらえる	言い拵える
言いこめる	いいこめる
言いこめる	言い籠める
言いこめる	言い込める
言いしらける	いいしらける
言いしらける	言い白ける
言いすぎる	いいすぎる
言いすぎる	言い過ぎる
言いすくめる	いいすくめる
言いすくめる	言い竦める
言いすてる	いいすてる
言いすてる	言い捨てる
言いそえる	いいそえる
言いそえる	言い添える
言いたてる	いいたてる
言いたてる	言い立てる
言いちがえる	いいちがえる
言いちがえる	言い違える
言いつける	いいつける
言いつける	言い付ける
言いつげる	いいつげる
言いつげる	言い告げる
言いつたえる	いいつたえる
言いつたえる	言い伝える
言いつづける	いいつづける
言いつづける	言い続ける
言いつめる	いいつめる
言いつめる	言い詰める
言いつらねる	いいつらねる
言いつらねる	言い連ねる
言いなれる	いいなれる
言いなれる	言い慣れる
言いなれる	言い馴れる
言いぬける	いいぬける
言いぬける	言い抜ける
言いのがれる	いいのがれる
言いのがれる	言い逃れる
言いのける	いいのける
言いのける	言い退ける
言いはぐれる	いいはぐれる
言いはぐれる	言い逸れる
言いはじめる	いいはじめる
言いはじめる	言い始める
言いひろめる	いいひろめる
言いひろめる	言い広める
言いふくめる	いいふくめる
言いふくめる	言い含める
言いふせる	いいふせる
言いふせる	言い伏せる
言いまける	いいまける
言いまける	言い負ける
言いまげる	いいまげる
言いまげる	言い曲げる
言いまるめる	いいまるめる
言いまるめる	言い丸める
言いれる	いいいれる
言いれる	言入れる
言いわける	いいわける
言いわける	言い分ける
言おくれる	いいおくれる
言おくれる	言遅れる
言かえる	いいかえる
言かえる	言換える
言かえる	言替える
言かける	いいかける
言かける	言掛ける
言かためる	いいかためる
言かためる	言固める
言きかせる	いいきかせる
言きかせる	言聞かせる
言すぎる	いいすぎる
言すぎる	言過ぎる
言すてる	いいすてる
言すてる	言捨てる
言そえる	いいそえる
言そえる	言添える
言たてる	いいたてる
言たてる	言立てる
言ちがえる	いいちがえる
言ちがえる	言違える
言つたえる	いいつたえる
言つたえる	言伝える
言つめる	いいつめる
言つめる	言詰める
言つらねる	いいつらねる
言つらねる	言連ねる
言づける	ことづける
言づける	言付ける
言なれる	いいなれる
言なれる	言慣れる
言ぬける	いいぬける
言ぬける	言抜ける
言のがれる	いいのがれる
言のがれる	言逃れる
言ひろめる	いいひろめる
言ひろめる	言広める
言ふくめる	いいふくめる
言ふくめる	言含める
言ふせる	いいふせる
言ふせる	言伏せる
言まける	いいまける
言まける	言負ける
言よせる	ことよせる
言よせる	言寄せる
言わける	いいわける
言わける	言分ける
訴えかける	うったえかける
訴えかける	訴え掛ける
訴えでる	うったえでる
訴えでる	訴え出る
詠いれる	よみいれる
詠いれる	詠入れる
詠すてる	よみすてる
詠すてる	詠捨てる
詠みいれる	よみいれる
詠みいれる	詠み入れる
詰あわせる	つめあわせる
詰あわせる	詰合わせる
詰かえる	つめかえる
詰かえる	詰替える
詰かける	つめかける
詰かける	詰掛ける
詰めあわせる	つめあわせる
詰めあわせる	詰め合せる
詰めあわせる	詰め合わせる
詰めかえる	つめかえる
詰めかえる	詰め替える
詰めかける	つめかける
詰めかける	詰め掛ける
詰めよせる	つめよせる
詰めよせる	詰め寄せる
詰よせる	つめよせる
詰よせる	詰寄せる
話しかける	はなしかける
話しかける	話しかける
話しかける	話し掛ける
話しつかれる	はなしつかれる
話しつかれる	話し疲れる
誉めあげる	ほめあげる
誉めあげる	誉め上げる
誉めたたえる	ほめたたえる
誉めたたえる	誉め称える
誉めたてる	ほめたてる
誉めたてる	誉め立てる
誘いあわせる	さそいあわせる
誘いあわせる	誘い合せる
誘いあわせる	誘い合わせる
誘いいれる	さそいいれる
誘いいれる	誘い入れる
誘いかける	さそいかける
誘いかける	誘い掛ける
誘きいれる	おびきいれる
誘きいれる	誘き入れる
誘きよせる	おびきよせる
誘きよせる	誘き寄せる
語りかける	かたりかける
語りかける	語り掛ける
語りきかせる	かたりきかせる
語りきかせる	語り聞かせる
語りつたえる	かたりつたえる
語りつたえる	語り伝える
説きかせる	とききかせる
説きかせる	説聞かせる
説ききかせる	とききかせる
説ききかせる	説き聞かせる
説きすすめる	ときすすめる
説きすすめる	説き勧める
説きたてる	ときたてる
説きたてる	説き立てる
説きつける	ときつける
説きつける	説き付ける
説きふせる	ときふせる
説きふせる	説き伏せる
説きわける	ときわける
説きわける	説き分ける
説ふせる	ときふせる
説ふせる	説伏せる
説わける	ときわける
説わける	説分ける
読あげる	よみあげる
読あげる	読上げる
読あわせる	よみあわせる
読あわせる	読合わせる
読かえる	よみかえる
読かえる	読替える
読かける	よみかける
読かける	読掛ける
読きかせる	よみきかせる
読きかせる	読聞かせる
読くらべる	よみくらべる
読くらべる	読比べる
読すてる	よみすてる
読すてる	読捨てる
読たてる	よみたてる
読たてる	読立てる
読ちがえる	よみちがえる
読ちがえる	読違える
読なれる	よみなれる
読なれる	読慣れる
読みあげる	よみあげる
読みあげる	読み上げる
読みあわせる	よみあわせる
読みあわせる	読み合せる
読みあわせる	読み合わせる
読みかえる	よみかえる
読みかえる	読み替える
読みかける	よみかける
読みかける	読み掛ける
読みきかせる	よみきかせる
読みきかせる	読み聞かせる
読みくらべる	よみくらべる
読みくらべる	読み比べる
読みすすめる	よみすすめる
読みすすめる	読み進める
読みすてる	よみすてる
読みすてる	読み捨てる
読みたてる	よみたてる
読みたてる	読み立てる
読みちがえる	よみちがえる
読みちがえる	読み違える
読みつける	よみつける
読みつける	読み付ける
読みなれる	よみなれる
読みなれる	読み慣れる
読みなれる	読み馴れる
読間ちがえる	よみまちがえる
読間ちがえる	読間違える
調べあげる	しらべあげる
調べあげる	調べ上げる
請いうける	こいうける
請いうける	請い受ける
請じいれる	しょうじいれる
請じいれる	請じ入れる
論じたてる	ろんじたてる
論じたてる	論じ立てる
諜じあわせる	ちょうじあわせる
諜じあわせる	諜じ合わせる
謳いあげる	うたいあげる
謳いあげる	謳い上げる
謳いあげる	謳い揚げる
警固みる	けごみる
警固みる	警固見る
譲りあたえる	ゆずりあたえる
譲りあたえる	譲り与える
譲りうける	ゆずりうける
譲りうける	譲り受ける
責かける	せめかける
責かける	責掛ける
責たてる	せめたてる
責たてる	責立てる
責めたてる	せめたてる
責めたてる	責め立てる
責めつける	せめつける
責めつける	責めつける
責めつける	責め付ける
貰いうける	もらいうける
貰いうける	貰い受ける
貰いさげる	もらいさげる
貰いさげる	貰い下げる
買あげる	かいあげる
買あげる	買上げる
買あたえる	かいあたえる
買あたえる	買与える
買あつめる	かいあつめる
買あつめる	買集める
買いあげる	かいあげる
買いあげる	買い上げる
買いあたえる	かいあたえる
買いあたえる	買い与える
買いあつめる	かいあつめる
買いあつめる	買い集める
買いいれる	かいいれる
買いいれる	買い入れる
買いうける	かいうける
買いうける	買い受ける
買いかえる	かいかえる
買いかえる	買い換える
買いかえる	買い替える
買いしめる	かいしめる
買いしめる	買い占める
買いそろえる	かいそろえる
買いそろえる	買い揃える
買いたてる	かいたてる
買いたてる	買い立てる
買いつける	かいつける
買いつける	買い付ける
買いととのえる	かいととのえる
買いととのえる	買い整える
買いととのえる	買い調える
買いひかえる	かいひかえる
買いひかえる	かいびかえる
買いひかえる	買い控える
買いまける	かいまける
買いまける	買い負ける
買いもとめる	かいもとめる
買いもとめる	買い求める
買いれる	かいいれる
買いれる	買入れる
買うける	かいうける
買うける	買受ける
買かえる	かいかえる
買かえる	買換える
買かえる	買替える
買しめる	かいしめる
買しめる	買占める
買たてる	かいたてる
買たてる	買立てる
買ととのえる	かいととのえる
買ととのえる	買整える
買まける	かいまける
買まける	買負ける
買もとめる	かいもとめる
買もとめる	買求める
貸あたえる	かしあたえる
貸あたえる	貸与える
貸さげる	かしさげる
貸さげる	貸下げる
貸しあたえる	かしあたえる
貸しあたえる	貸し与える
貸しさげる	かしさげる
貸しさげる	貸し下げる
貸しつける	かしつける
貸しつける	貸し付ける
貼かえる	はりかえる
貼かえる	貼替える
貼りあわせる	はりあわせる
貼りあわせる	貼り合せる
貼りあわせる	貼り合わせる
貼りかえる	はりかえる
貼りかえる	貼り替える
貼りつける	はりつける
貼りつける	貼り付ける
贏ちえる	かちえる
贏ちえる	贏ち得る
走りすぎる	はしりすぎる
走りすぎる	走り過ぎる
走りでる	はしりでる
走りでる	走り出る
走りぬける	はしりぬける
走りぬける	走り抜ける
足しあわせる	たしあわせる
足しあわせる	足し合わせる
跡づける	あとづける
跡づける	跡付ける
跳こえる	とびこえる
跳こえる	跳越える
跳ねあげる	はねあげる
跳ねあげる	跳ね上げる
跳ねおきる	はねおきる
跳ねおきる	跳ね起きる
跳びこえる	とびこえる
跳びこえる	跳び越える
踏いれる	ふみいれる
踏いれる	踏入れる
踏かえる	ふみかえる
踏かえる	踏換える
踏かえる	踏替える
踏かためる	ふみかためる
踏かためる	踏固める
踏こえる	ふみこえる
踏こえる	踏越える
踏しめる	ふみしめる
踏しめる	踏締める
踏たてる	ふみたてる
踏たてる	踏立てる
踏ちがえる	ふみちがえる
踏ちがえる	踏違える
踏みいれる	ふみいれる
踏みいれる	踏み入れる
踏みかえる	ふみかえる
踏みかえる	踏み替える
踏みかためる	ふみかためる
踏みかためる	踏み固める
踏みこえる	ふみこえる
踏みこえる	踏み越える
踏みこたえる	ふみこたえる
踏みこたえる	踏みこたえる
踏みこたえる	踏み堪える
踏みしめる	ふみしめる
踏みしめる	踏み締める
踏みたてる	ふみたてる
踏みたてる	踏み立てる
踏みちがえる	ふみちがえる
踏みちがえる	踏み違える
踏みつける	ふみつける
踏みつける	踏み付ける
踏みはだける	ふみはだける
踏みはだける	踏み開ける
踏みわける	ふみわける
踏みわける	踏み分ける
踏わける	ふみわける
踏わける	踏分ける
踏んづける	ふんづける
踏んづける	踏ん付ける
蹴あげる	けあげる
蹴あげる	蹴上げる
蹴たてる	けたてる
蹴たてる	蹴立てる
蹴ちがえる	けちがえる
蹴ちがえる	蹴違える
蹴のける	けのける
蹴のける	蹴退ける
蹴りあげる	けりあげる
蹴りあげる	蹴り上げる
蹴りいれる	けりいれる
蹴りいれる	蹴り入れる
蹴りつける	けりつける
蹴りつける	蹴り付ける
躍りでる	おどりでる
躍りでる	躍り出る
躙りでる	にじりでる
躙りでる	躙り出る
転がりおちる	ころがりおちる
転がりおちる	転がり落ちる
転がりでる	ころがりだす
転がりでる	転がり出る
転げおちる	ころげおちる
転げおちる	転げ落ちる
転げでる	ころげでる
転げでる	転げ出る
載せかける	のせかける
載せかける	載せ掛ける
輝きでる	かがやきでる
輝きでる	輝き出る
込あげる	こみあげる
込あげる	込上げる
込みあげる	こみあげる
込みあげる	込み上げる
迎えいれる	むかえいれる
迎えいれる	迎え入れる
近づける	ちかづける
近づける	近付ける
近よせる	ちかよせる
近よせる	近寄せる
迫りあげる	せりあげる
迫りあげる	迫り上げる
迫りたてる	せりたてる
迫りたてる	迫り立てる
迫りつめる	せりつめる
迫りつめる	迫り詰める
述べたてる	のべたてる
述べたてる	述べ立てる
迷いでる	まよいでる
迷いでる	迷い出る
追あげる	おいあげる
追あげる	追上げる
追いあげる	おいあげる
追いあげる	追い上げる
追いいれる	おいいれる
追いいれる	追い入れる
追いかける	おいかける
追いかける	追い掛ける
追いたてる	おいたてる
追いたてる	追い立てる
追いつめる	おいつめる
追いつめる	追い詰める
追いのける	おいのける
追いのける	追い退ける
追いもとめる	おいもとめる
追いもとめる	追い求める
追かける	おいかける
追かける	追掛ける
追たてる	おいたてる
追たてる	追立てる
追っかける	おっかける
追っかける	ぼっかける
追っかける	追っ掛ける
追ったてる	ぼったてる
追ったてる	追っ立てる
追っぼっかける	ぼっかける
追っぼっかける	追っ掛ける
追っぼったてる	ぼったてる
追っぼったてる	追っ立てる
追つめる	おいつめる
追つめる	追詰める
追もとめる	おいもとめる
追もとめる	追求める
追んでる	おんでる
追んでる	追ん出る
送りつける	おくりつける
送りつける	送り付ける
送りとどける	おくりとどける
送りとどける	送り届ける
逃おくれる	にげおくれる
逃おくれる	逃遅れる
逃おちる	にげおちる
逃おちる	逃落ちる
逃げうせる	にげうせる
逃げうせる	逃げ失せる
逃げおおせる	にげおおせる
逃げおおせる	逃げ果せる
逃げおくれる	にげおくれる
逃げおくれる	逃げ遅れる
逃げおちる	にげおちる
逃げおちる	逃げ落ちる
逃げかくれる	にげかくれる
逃げかくれる	逃げ隠れる
逃げでる	にげでる
逃げでる	逃げ出る
逃げのびる	にげのびる
逃げのびる	逃げ延びる
逃のびる	にげのびる
逃のびる	逃延びる
逃れでる	のがれでる
逃れでる	逃れ出る
透かしみる	すかしみる
透かしみる	透かし見る
這いおりる	はいおりる
這いおりる	這い降りる
這いでる	はいでる
這いでる	這い出る
通いつめる	かよいつめる
通いつめる	通い詰める
通りあわせる	とおりあわせる
通りあわせる	通り合せる
通りあわせる	通り合わせる
通りすぎる	とおりすぎる
通りすぎる	通り過ぎる
通りぬける	とおりぬける
通りぬける	通り抜ける
造りたてる	つくりたてる
造りたてる	造り立てる
逢いみる	あいみる
逢いみる	逢い見る
連べかける	つるべかける
連べかける	連べ掛ける
進みでる	すすみでる
進みでる	進み出る
遊びたわむれる	あそびたわむれる
遊びたわむれる	遊び戯れる
遊びつかれる	あそびつかれる
遊びつかれる	遊び疲れる
遊びほうける	あそびほうける
遊びほうける	遊び呆ける
運びあげる	はこびあげる
運びあげる	運び上げる
運びいれる	はこびいれる
運びいれる	運び入れる
運命づける	うんめいづける
運命づける	運命付ける
遠のける	とおのける
遠のける	遠退ける
遣ってのける	やってのける
遣ってのける	遣って退ける
遣りあげる	やりあげる
遣りあげる	遣り上げる
遣りかえる	やりかえる
遣りかえる	遣り替える
遣りかける	やりかける
遣りかける	遣り掛ける
遣りこめる	やりこめる
遣りこめる	遣り込める
遣りすぎる	やりすぎる
遣りすぎる	遣り過ぎる
遣りちがえる	やりちがえる
遣りちがえる	遣り違える
遣りとげる	やりとげる
遣りとげる	遣り遂げる
遣りのける	やりのける
遣りのける	遣り退ける
選りよりわける	よりわける
選りよりわける	選り分ける
選りわける	えりわける
選りわける	よりわける
選りわける	選り分ける
酌みわける	くみわける
酌みわける	酌み分ける
酌わける	くみわける
酌わける	酌分ける
酔いしれる	よいしれる
酔いしれる	酔いしれる
酔いしれる	酔い痴れる
酔いつぶれる	よいつぶれる
酔いつぶれる	酔い潰れる
重ねあげる	かさねあげる
重ねあげる	重ね上げる
釣あげる	つりあげる
釣あげる	釣上げる
釣さげる	つりさげる
釣さげる	釣下げる
釣りあげる	つりあげる
釣りあげる	釣り上げる
釣りさげる	つりさげる
釣りさげる	釣り下げる
釣瓶かける	つるべかける
釣瓶かける	釣瓶掛ける
鋳かける	いかける
鋳かける	鋳掛ける
錬りあげる	ねりあげる
錬りあげる	錬り上げる
鍛えあげる	きたえあげる
鍛えあげる	鍛え上げる
鎖しかためる	さしかためる
鎖しかためる	鎖し固める
鎖しこめる	さしこめる
鎖しこめる	鎖し籠める
閉こめる	とじこめる
閉こめる	閉込める
閉じこめる	とじこめる
閉じこめる	閉じ込める
閉てこめる	たてこめる
閉てこめる	閉て込める
開けひらける	ひらける
開けひらける	開ける
開けひろげる	あけひろげる
開けひろげる	開け広げる
間ちがえる	まちがえる
間ちがえる	間違える
間にあわせる	まにあわせる
間にあわせる	間に合わせる
関係づける	かんけいづける
関係づける	関係付ける
関連づける	かんれんづける
関連づける	関連付ける
降こめる	ふりこめる
降こめる	降籠める
降りおちる	ふりおちる
降りおちる	降り落ちる
降りおりる	おりる
降りおりる	降りる
降りこめる	ふりこめる
降りこめる	降り籠める
雇いいれる	やといいれる
雇いいれる	雇い入れる
離れおちる	はなれおちる
離れおちる	離れ落ちる
雪崩おちる	なだれおちる
雪崩おちる	雪崩落ちる
零れおちる	こぼれおちる
零れおちる	零れ落ちる
預けいれる	あずけいれる
預けいれる	預け入れる
頭ぬける	ずぬける
頭ぬける	頭抜ける
願いあげる	ねがいあげる
願いあげる	願い上げる
願いさげる	ねがいさげる
願いさげる	願い下げる
願いでる	ねがいでる
願いでる	願い出る
飛おきる	とびおきる
飛おきる	飛起きる
飛おりる	とびおりる
飛おりる	飛下りる
飛おりる	飛降りる
飛こえる	とびこえる
飛こえる	飛越える
飛でる	とびでる
飛でる	飛出る
飛ぬける	とびぬける
飛ぬける	飛抜ける
飛はなれる	とびはなれる
飛はなれる	飛離れる
飛はねる	とびはねる
飛はねる	飛跳ねる
飛びおきる	とびおきる
飛びおきる	飛び起きる
飛びおりる	とびおりる
飛びおりる	飛び下りる
飛びおりる	飛び降りる
飛びこえる	とびこえる
飛びこえる	飛び越える
飛びでる	とびでる
飛びでる	飛び出る
飛びぬける	とびぬける
飛びぬける	飛び抜ける
飛びはなれる	とびはなれる
飛びはなれる	飛び離れる
飛びはねる	とびはねる
飛びはねる	飛び跳ねる
食あわせる	くいあわせる
食あわせる	食合わせる
食いあきる	くいあきる
食いあきる	食い厭きる
食いあきる	食い飽きる
食いあわせる	くいあわせる
食いあわせる	食い合せる
食いあわせる	食い合わせる
食いかける	くいかける
食いかける	食い掛ける
食いかねる	くいかねる
食いかねる	食い兼ねる
食いしめる	くいしめる
食いしめる	食い締める
食いすぎる	くいすぎる
食いすぎる	食い過ぎる
食いっぱぐれる	くいっぱぐれる
食いっぱぐれる	食いっ逸れる
食いつめる	くいつめる
食いつめる	食い詰める
食いとめる	くいとめる
食いとめる	食い止める
食いはぐれる	くいはぐれる
食いはぐれる	食いはぐれる
食いはぐれる	食い逸れる
食かける	くいかける
食かける	食掛ける
食しめる	くいしめる
食しめる	食締める
食すぎる	くいすぎる
食すぎる	食過ぎる
食つめる	くいつめる
食つめる	食詰める
食べかける	たべかける
食べかける	食べ掛ける
食べくらべる	たべくらべる
食べくらべる	食べ比べる
食べすぎる	たべすぎる
食べすぎる	食べ過ぎる
食べつける	たべつける
食べつける	食べ付ける
食べなれる	たべなれる
食べなれる	食べ慣れる
食べわける	たべわける
食べわける	食べ分ける
食みでる	はみでる
食みでる	食み出る
飲かける	のみかける
飲かける	飲掛ける
飲つぶれる	のみつぶれる
飲つぶれる	飲潰れる
飲みかける	のみかける
飲みかける	飲み掛ける
飲みくらべる	のみくらべる
飲みくらべる	飲み比べる
飲みつける	のみつける
飲みつける	飲み付ける
飲みつぶれる	のみつぶれる
飲みつぶれる	飲み潰れる
飲みわける	のみわける
飲みわける	飲み分ける
飽きたりる	あきたりる
飽きたりる	飽き足りる
飽たりる	あきたりる
飽たりる	飽足りる
飾りたてる	かざりたてる
飾りたてる	飾り立てる
飾りつける	かざりつける
飾りつける	飾り付ける
養いそだてる	やしないそだてる
養いそだてる	養い育てる
馳せさんじる	はせさんじる
馳せさんじる	馳せ参じる
馳せつける	はせつける
馳せつける	馳せ着ける
馴れそめる	なれそめる
馴れそめる	馴れ初める
駆あつめる	かりあつめる
駆あつめる	駆集める
駆おりる	かけおりる
駆おりる	駆降りる
駆けおりる	かけおりる
駆けおりる	駆け下りる
駆けおりる	駆け降りる
駆けくらべる	かけくらべる
駆けくらべる	駆け比べる
駆けつける	かけつける
駆けつける	駆け付ける
駆けぬける	かけぬける
駆けぬける	駆け抜ける
駆たてる	かりたてる
駆たてる	駆立てる
駆ぬける	かけぬける
駆ぬける	駆抜ける
駆りあつめる	かりあつめる
駆りあつめる	駆り集める
駆りたてる	かりたてる
駆りたてる	駆り立てる
駈けおりる	かけおりる
駈けおりる	駈け降りる
駈けつける	かけつける
駈けつける	駈け着ける
駈けぬける	かけぬける
駈けぬける	駈け抜ける
騒ぎたてる	さわぎたてる
騒ぎたてる	騒ぎ立てる
驚きあきれる	おどろきあきれる
驚きあきれる	驚き呆れる
鳴きたてる	なきたてる
鳴きたてる	鳴き立てる
鳴たてる	なきたてる
鳴たてる	鳴立てる
