あいぐす	あいぐす
あいする	あいする
あいせっする	あいせっする
あいぜんごする	あいぜんごする
あいたいする	あいたいする
あいつうずる	あいつうずる
あいとうずる	あいとうずる
あいなかばする	あいなかばする
あいはんする	あいはんする
あいます	あいます
あいようする	あいようする
あいわする	あいわする
あえす	あえす
あくする	あくする
あしくす	あしくす
あせす	あせす
あせする	あせする
あたいする	あたいする
あだする	あだする
あちこちする	あちこちする
あっす	あっす
あっする	あっする
あまんず	あまんず
あまんずる	あまんずる
あみす	あみす
あんず	あんず
あんずる	あんずる
いいきす	いいきす
いいくんず	いいくんず
いおりす	いおりす
いくする	いくする
いする	いする
いたいけす	いたいけす
いっす	いっす
いっする	いっする
いまそうず	いまそうず
いんする	いんする
うけそんずる	うけそんずる
うず	うず
うちあんず	うちあんず
うちきょうずる	うちきょうずる
うちくっす	うちくっす
うちくんず	うちくんず
うちぐす	うちぐす
うちす	うちす
うちそんずる	うちそんずる
うちちょうず	うちちょうず
うっする	うっする
うとんず	うとんず
うとんずる	うとんずる
うんずる	うんずる
えいず	えいず
えいずる	えいずる
えきす	えきす
えきする	えきする
えす	えす
えず	えず
えっす	えっす
えっする	えっする
えんす	えんす
えんず	えんず
えんずる	えんずる
おいす	おいす
おうず	おうず
おうずる	おうずる
おきふるす	おきふるす
おくす	おくす
おくする	おくする
おちゃする	おちゃする
おとこす	おとこす
おとする	おとする
おもいうんず	おもいうんず
おもいくっする	おもいくっする
おもいくんず	おもいくんず
おもいねんず	おもいねんず
おもくす	おもくす
おもんず	おもんず
おもんずる	おもんずる
おわす	おわす
おわそうず	おわそうず
かいする	かいする
かえにす	かえにす
かきそんずる	かきそんずる
かくす	かくす
かくする	かくする
かす	かす
かする	かする
かたす	かたす
かたみす	かたみす
かたんずる	かたんずる
かっす	かっす
かっする	かっする
かみする	かみする
かろんず	かろんず
かろんずる	かろんずる
かんす	かんす
かんする	かんする
かんず	かんず
かんずる	かんずる
がいす	がいす
がいする	がいする
がえんず	がえんず
がえんずる	がえんずる
がくす	がくす
がす	がす
がする	がする
がっす	がっす
がっする	がっする
きえす	きえす
きくす	きくす
きくする	きくする
きす	きす
きする	きする
きたする	きたする
きっす	きっす
きっする	きっする
きゅうす	きゅうす
きゅうする	きゅうする
きょうす	きょうす
きょうする	きょうする
きょうず	きょうず
きょうずる	きょうずる
きょくする	きょくする
きょす	きょす
きょする	きょする
きんす	きんす
きんず	きんず
きんずる	きんずる
ぎする	ぎする
ぎゃくする	ぎゃくする
ぎょうずる	ぎょうずる
ぎょす	ぎょす
ぎょする	ぎょする
ぎんず	ぎんず
ぎんずる	ぎんずる
くうず	くうず
くす	くす
くちす	くちす
くっす	くっす
くっする	くっする
くみする	くみする
くらいする	くらいする
くんず	くんず
くんずる	くんずる
ぐうす	ぐうす
ぐうする	ぐうする
ぐす	ぐす
ぐする	ぐする
けいす	けいす
けいする	けいする
けす	けす
けそうず	けそうず
けっす	けっす
けっする	けっする
けみす	けみす
けみする	けみする
けんす	けんす
けんする	けんする
けんず	けんず
けんずる	けんずる
げいす	げいす
げきす	げきす
げきする	げきする
げす	げす
げんする	げんする
げんず	げんず
げんずる	げんずる
こいする	こいする
こうす	こうす
こうする	こうする
こうず	こうず
こうずる	こうずる
こくす	こくす
こくする	こくする
こころす	こころす
こころする	こころする
こす	こす
こする	こする
こどもこどもする	こどもこどもする
こんする	こんする
こんず	こんず
こんずる	こんずる
ごいっしょする	ごいっしょする
ごうす	ごうす
ごうする	ごうする
ごす	ごす
ごする	ごする
ごらんず	ごらんず
ごろうず	ごろうず
さいす	さいす
さいする	さいする
さいわいする	さいわいする
さかいする	さかいする
さきんずる	さきんずる
さくす	さくす
さくする	さくする
さっす	さっす
さっする	さっする
さみす	さみす
さみする	さみする
さんす	さんす
さんする	さんする
さんずる	さんずる
ざする	ざする
ざんする	ざんする
しいする	しいする
しかとする	しかとする
しす	しす
しする	しする
しそんずる	しそんずる
しっす	しっす
しっする	しっする
しにす	しにす
しゃくす	しゃくす
しゃくする	しゃくする
しゃす	しゃす
しゃする	しゃする
しゅうす	しゅうす
しゅうする	しゅうする
しゅくす	しゅくす
しゅくする	しゅくする
しゅす	しゅす
しゅする	しゅする
しゅっす	しゅっす
しょうする	しょうする
しょうずる	しょうずる
しょくす	しょくす
しょくする	しょくする
しょする	しょする
しんずる	しんずる
じする	じする
じゃくす	じゃくす
じゃくする	じゃくする
じゅうす	じゅうす
じゅうする	じゅうする
じゅくする	じゅくする
じゅす	じゅす
じゅする	じゅする
じゅんずる	じゅんずる
じょうする	じょうする
じょうず	じょうず
じょうずる	じょうずる
じょす	じょす
じょする	じょする
じんす	じんす
じんする	じんする
す	す
すいする	すいする
する	する
ずうず	ずうず
ずす	ずす
ずする	ずする
ずんず	ずんず
せいする	せいする
せきす	せきす
せす	せす
せっする	せっする
せんする	せんする
せんず	せんず
せんずる	せんずる
ぜいする	ぜいする
ぜす	ぜす
ぜっする	ぜっする
そうする	そうする
そうず	そうず
そくする	そくする
そす	そす
そっす	そっす
そらんずる	そらんずる
そんする	そんする
そんずる	そんずる
ぞうする	ぞうする
ぞくする	ぞくする
ぞんずる	ぞんずる
たいする	たいする
たえす	たえす
たくす	たくす
たくする	たくする
たくましくする	たくましくする
たくましゅうする	たくましゅうする
たぐいする	たぐいする
たっする	たっする
たびする	たびする
たむろする	たむろする
たんずる	たんずる
だいする	だいする
だくする	だくする
だする	だする
だっする	だっする
だんず	だんず
だんずる	だんずる
ちする	ちする
ちっす	ちっす
ちっする	ちっする
ちゃくする	ちゃくする
ちゅうする	ちゅうする
ちょうす	ちょうす
ちょうする	ちょうする
ちょうず	ちょうず
ちょうずる	ちょうずる
ちょくす	ちょくす
ちんする	ちんする
ちんずる	ちんずる
ついす	ついす
つうずる	つうずる
つきす	つきす
つばする	つばする
つみする	つみする
ていする	ていする
てきする	てきする
てっする	てっする
てんす	てんす
てんする	てんする
てんずる	てんずる
とうする	とうする
とうず	とうず
とうずる	とうずる
とくする	とくする
とす	とす
とする	とする
とどす	とどす
となりする	となりする
とみす	とみす
とりぐす	とりぐす
とりす	とりす
とんす	とんす
とんする	とんする
とんず	とんず
どうずる	どうずる
どくする	どくする
どする	どする
どんする	どんする
なくする	なくする
なにする	なにする
なみする	なみする
なみだする	なみだする
ならびしょうする	ならびしょうする
なんする	なんする
なんずる	なんずる
なんなんとする	なんなんとする
にえす	にえす
にしする	にしする
にんず	にんず
にんずる	にんずる
ねいする	ねいする
ねす	ねす
ねっする	ねっする
ねんず	ねんず
ねんずる	ねんずる
のりぐす	のりぐす
のりする	のりする
はいする	はいする
はえす	はえす
はくする	はくする
はす	はす
はする	はする
はせさんずる	はせさんずる
はっする	はっする
はれす	はれす
はんする	はんする
はんずる	はんずる
ばいす	ばいす
ばいする	ばいする
ばくする	ばくする
ばっする	ばっする
ばんず	ばんず
ばんずる	ばんずる
ひがしする	ひがしする
ひきぐす	ひきぐす
ひきぐする	ひきぐする
ひす	ひす
ひする	ひする
ひだりする	ひだりする
ひっす	ひっす
ひっする	ひっする
ひょうす	ひょうす
ひょうする	ひょうする
ひんす	ひんす
ひんする	ひんする
びする	びする
ふうする	ふうする
ふうずる	ふうずる
ふくす	ふくす
ふくする	ふくする
ふす	ふす
ふする	ふする
ふたする	ふたする
ふりす	ふりす
ふんする	ふんする
ふんず	ふんず
ぶくす	ぶくす
ぶす	ぶす
ぶする	ぶする
ぶんず	ぶんず
へいする	へいする
へきする	へきする
へんす	へんす
へんする	へんする
へんずる	へんずる
べんする	べんする
べんずる	べんずる
ほうする	ほうする
ほうず	ほうず
ほうずる	ほうずる
ほす	ほす
ほする	ほする
ほっする	ほっする
ほりす	ほりす
ぼうず	ぼうず
ぼうずる	ぼうずる
ぼくする	ぼくする
ぼっする	ぼっする
ぼんす	ぼんす
ぽいする	ぽいする
まくらする	まくらする
まする	まする
まっする	まっする
まっとうする	まっとうする
まんず	まんず
まんずる	まんずる
みぎする	みぎする
みする	みする
みそんずる	みそんずる
みなみする	みなみする
めいす	めいす
めいする	めいする
めいずる	めいずる
めしぐす	めしぐす
めっする	めっする
めんする	めんする
めんずる	めんずる
もくす	もくす
もくする	もくする
もする	もする
もっす	もっす
もっちょうずる	もっちょうずる
もてきょうず	もてきょうず
もて興ず	もて興ず
ものする	ものする
やくする	やくする
やすんずる	やすんずる
やりそんずる	やりそんずる
ゆうす	ゆうす
ゆうする	ゆうする
ゆす	ゆす
ゆする	ゆする
ようす	ようす
ようする	ようする
ようず	ようず
よくする	よくする
よびぐす	よびぐす
よみする	よみする
よみそんずる	よみそんずる
よわいする	よわいする
らいす	らいす
らくする	らくする
らっする	らっする
らんする	らんする
りくする	りくする
りす	りす
りする	りする
りっする	りっする
りゃくする	りゃくする
りょうする	りょうする
りょうず	りょうず
るいする	るいする
れいする	れいする
れっする	れっする
れんず	れんず
ろうする	ろうする
ろうず	ろうず
ろくす	ろくす
ろくする	ろくする
ろんずる	ろんずる
わざわいする	わざわいする
わする	わする
わたくしする	わたくしする
上する	上する
与する	与する
並び称する	並び称する
中する	中する
乗ずる	乗ずる
乗り具す	乗り具す
了する	了する
亡くする	亡くする
亡ず	亡ず
仇する	仇する
介する	介する
仕損ずる	仕損ずる
付する	付する
令する	令する
任ずる	任ずる
伍する	伍する
伏する	伏する
休す	休す
休する	休する
会す	会す
会する	会する
位する	位する
住す	住す
住する	住する
体する	体する
何する	何する
何為る	何為る
作する	作する
佞する	佞する
佩する	佩する
例する	例する
侍する	侍する
供する	供する
供ず	供ず
価する	価する
便する	便する
便ずる	便ずる
保する	保する
信ずる	信ずる
修す	修す
修する	修する
俯す	俯す
倍する	倍する
候ず	候ず
値する	値する
倦ず	倦ず
倦ずる	倦ずる
倦んずる	倦んずる
倶する	倶する
偈す	偈す
偏する	偏する
僄す	僄す
僭する	僭する
僻する	僻する
先ず	先ず
先んずる	先んずる
克する	克する
免ずる	免ずる
党する	党する
全うする	全うする
具す	具す
具する	具する
典す	典す
典する	典する
兼す	兼す
冊す	冊す
冠す	冠す
冠する	冠する
冲する	冲する
准ずる	准ずる
凌ず	凌ず
処する	処する
分ず	分ず
刊する	刊する
刑す	刑す
刑する	刑する
列する	列する
判ずる	判ずる
利する	利する
刮する	刮する
制する	制する
刻する	刻する
則する	則する
剋する	剋する
劃する	劃する
労する	労する
勅す	勅す
勒す	勒す
勒する	勒する
動ずる	動ずる
勘ず	勘ず
化す	化す
化する	化する
化粧ず	化粧ず
北する	北する
医する	医する
卒す	卒す
南する	南する
博する	博する
卜する	卜する
印する	印する
即する	即する
参する	参する
参ずる	参ずる
反する	反する
取り具す	取り具す
受け損ずる	受け損ずる
受損ずる	受損ずる
叙する	叙する
叛する	叛する
古りす	古りす
召し具す	召し具す
右する	右する
号す	号す
号する	号する
吃す	吃す
吃する	吃する
合す	合す
合する	合する
同ずる	同ずる
吐す	吐す
吟ず	吟ず
吟ずる	吟ずる
呈する	呈する
呪す	呪す
呪する	呪する
呵す	呵す
呵する	呵する
呼び具す	呼び具す
命ずる	命ずる
和す	和す
和する	和する
品する	品する
哭す	哭す
哭する	哭する
唾する	唾する
啓す	啓す
啓する	啓する
啖ず	啖ず
善くする	善くする
善みする	善みする
喝す	喝す
喝する	喝する
喫す	喫す
喫する	喫する
嘆ずる	嘆ずる
嘉する	嘉する
嘱する	嘱する
嘲す	嘲す
嚇す	嚇す
囀ずる	囀ずる
困ずる	困ずる
圧す	圧す
圧する	圧する
坐さうず	坐さうず
坐する	坐する
垂んとする	垂んとする
執す	執す
執する	執する
執りす	執りす
堕する	堕する
報ずる	報ずる
境する	境する
変ずる	変ずる
夭する	夭する
失する	失する
奉ずる	奉ずる
奏する	奏する
好する	好する
妊ず	妊ず
委する	委する
姦する	姦する
婚する	婚する
婬する	婬する
嫁する	嫁する
子供子供する	子供子供する
存する	存する
存ずる	存ずる
孝ず	孝ず
学す	学す
安んずる	安んずる
宣する	宣する
害する	害する
宴す	宴す
宿す	宿す
宿する	宿する
寂す	寂す
寂する	寂する
寇す	寇す
寇する	寇する
富す	富す
寒ず	寒ず
寒ずる	寒ずる
寓す	寓す
寓する	寓する
察す	察す
察する	察する
寵す	寵す
寵する	寵する
対す	対す
対する	対する
封ず	封ず
封ずる	封ずる
尽きす	尽きす
尾する	尾する
局する	局する
居す	居す
屈す	屈す
屈する	屈する
屈ず	屈ず
展ずる	展ずる
属す	属す
属する	属する
屯す	屯す
屯する	屯する
崩ずる	崩ずる
嵩ずる	嵩ずる
左する	左する
帯する	帯する
帰する	帰する
幸いする	幸いする
幸す	幸す
幹する	幹する
幼気す	幼気す
幽す	幽す
序する	序する
度する	度する
座す	座す
座する	座する
庵す	庵す
廃する	廃する
弁ずる	弁ずる
弄する	弄する
弑す	弑す
弑する	弑する
弔する	弔する
引き具する	引き具する
引具す	引具す
引具する	引具する
弾ずる	弾ずる
役す	役す
役する	役する
彼方此方する	彼方此方する
征する	征する
律する	律する
後す	後す
得する	得する
御する	御する
御一緒する	御一緒する
御座さうず	御座さうず
御座す	御座す
御茶する	御茶する
御覧ず	御覧ず
復する	復する
徳する	徳する
徴する	徴する
徹する	徹する
心す	心す
心する	心する
必する	必する
忘ずる	忘ずる
応ず	応ず
応ずる	応ずる
念ずる	念ずる
思い屈する	思い屈する
思ひ倦んず	思ひ倦んず
思ひ屈ず	思ひ屈ず
思ひ念ず	思ひ念ず
怨ず	怨ず
怨ずる	怨ずる
恋する	恋する
恕す	恕す
恕する	恕する
悪しくす	悪しくす
愛する	愛する
感ず	感ず
感ずる	感ずる
慢ずる	慢ずる
慨する	慨する
慰する	慰する
慶す	慶す
慶する	慶する
懲ず	懲ず
懸想ず	懸想ず
成ず	成ず
戮する	戮する
打ず	打ず
打ちす	打ちす
打ちちょうず	打ちちょうず
打ち具す	打ち具す
打ち屈す	打ち屈す
打ち屈ず	打ち屈ず
打ち損ずる	打ち損ずる
打ち案ず	打ち案ず
打ち為	打ち為
打ち興ずる	打ち興ずる
打ち調ず	打ち調ず
打興ずる	打興ずる
托する	托する
扮する	扮する
扼する	扼する
抄する	抄する
投ず	投ず
投ずる	投ずる
抗す	抗す
抗する	抗する
抹する	抹する
拈ず	拈ず
拉する	拉する
招ずる	招ずる
拝する	拝する
拱する	拱する
拷ず	拷ず
持する	持する
挈する	挈する
按ずる	按ずる
挙す	挙す
挺する	挺する
捻ず	捻ず
排する	排する
接する	接する
推する	推する
掬す	掬す
掬する	掬する
揖す	揖す
握する	握する
揺す	揺す
損する	損する
損ずる	損ずる
搭ずる	搭ずる
摂する	摂する
摩する	摩する
摸する	摸する
摹する	摹する
撒する	撒する
撤する	撤する
撫す	撫す
撫する	撫する
撰する	撰する
擁する	擁する
擐する	擐する
擬する	擬する
攪する	攪する
敗する	敗する
散ずる	散ずる
敬す	敬す
敬する	敬する
敵する	敵する
断ずる	断ずる
施す	施す
旅する	旅する
旧す	旧す
旧りす	旧りす
昂ずる	昂ずる
映ず	映ず
映ずる	映ずる
是す	是す
晩ず	晩ず
晩ずる	晩ずる
晴れす	晴れす
書き損ずる	書き損ずる
書する	書する
書損ずる	書損ずる
有する	有する
服す	服す
服する	服する
朝する	朝する
期す	期す
期する	期する
朽ちす	朽ちす
東する	東する
枕する	枕する
架する	架する
柬する	柬する
校する	校する
案ず	案ず
案ずる	案ずる
梟する	梟する
検する	検する
概す	概す
模する	模する
檄する	檄する
欲す	欲す
欲する	欲する
欽す	欽す
歎ずる	歎ずる
歩す	歩す
歯す	歯す
歯する	歯する
死す	死す
死する	死する
死にす	死にす
殂す	殂す
殉ずる	殉ずる
殯す	殯す
毒する	毒する
比する	比する
汗す	汗す
汗する	汗する
決す	決す
決する	決する
沐する	沐する
沖する	沖する
没す	没す
没する	没する
治する	治する
泊する	泊する
注する	注する
派する	派する
浴する	浴する
消えす	消えす
消する	消する
涙する	涙する
淫する	淫する
混ず	混ず
混ずる	混ずる
渇す	渇す
渇する	渇する
減ず	減ず
減ずる	減ずる
満ず	満ず
満ずる	満ずる
準ずる	準ずる
滅する	滅する
漁す	漁す
漁する	漁する
演ず	演ず
演ずる	演ずる
潮する	潮する
激す	激す
激する	激する
濫する	濫する
瀉す	瀉す
瀉する	瀉する
瀕する	瀕する
災いする	災いする
点ずる	点ずる
為	為
為る	為る
為損ずる	為損ずる
焙ずる	焙ずる
無くする	無くする
無みする	無みする
煎ずる	煎ずる
熟する	熟する
熱す	熱す
熱する	熱する
燗する	燗する
燻ずる	燻ずる
牒ず	牒ず
牧する	牧する
物する	物する
犯す	犯す
状する	状する
狂する	狂する
狭みす	狭みす
狭みする	狭みする
猜する	猜する
猟する	猟する
献ず	献ず
献ずる	献ずる
率す	率す
現ず	現ず
現ずる	現ずる
理す	理す
瑩ず	瑩ず
甘んず	甘んず
甘んずる	甘んずる
生えす	生えす
生ずる	生ずる
産す	産す
産する	産する
甦す	甦す
用す	用す
男す	男す
画する	画する
略する	略する
疎んず	疎んず
疎んずる	疎んずる
痼す	痼す
療する	療する
発する	発する
益する	益する
監する	監する
目する	目する
相する	相する
相具す	相具す
相前後する	相前後する
相半ばする	相半ばする
相反する	相反する
相和する	相和する
相対する	相対する
相投ずる	相投ずる
相接する	相接する
相摩す	相摩す
相擁する	相擁する
相通ずる	相通ずる
省する	省する
眩する	眩する
着す	着す
着する	着する
督する	督する
瞑す	瞑す
瞑する	瞑する
瞽す	瞽す
破す	破す
礼す	礼す
礼する	礼する
祝する	祝する
禁ず	禁ず
禁ずる	禁ずる
禍する	禍する
私する	私する
私するまくらする	私するまくらする
科する	科する
秘する	秘する
称する	称する
稿する	稿する
窮す	窮す
窮する	窮する
竄する	竄する
筆す	筆す
策する	策する
算する	算する
箝する	箝する
管する	管する
節する	節する
簒する	簒する
糊する	糊する
約する	約する
組する	組する
結する	結する
給する	給する
絶えす	絶えす
絶する	絶する
網す	網す
緘する	緘する
練ず	練ず
縛する	縛する
罪する	罪する
置き旧す	置き旧す
罰する	罰する
署する	署する
老いす	老いす
老する	老する
聘する	聘する
聾する	聾する
肩す	肩す
肯にす	肯にす
肯へにす	肯へにす
肯んず	肯んず
肯んずる	肯んずる
育する	育する
能くする	能くする
脱する	脱する
臆す	臆す
臆する	臆する
臥する	臥する
興ず	興ず
興ずる	興ずる
航する	航する
艤する	艤する
草する	草する
落する	落する
著する	著する
蓋する	蓋する
蔑する	蔑する
蔵する	蔵する
薨ず	薨ず
薨ずる	薨ずる
薫ずる	薫ずる
蘇す	蘇す
虐する	虐する
虚す	虚す
蝕する	蝕する
蟄す	蟄す
蟄する	蟄する
行ずる	行ずる
表する	表する
裁す	裁す
裁する	裁する
補す	補す
補する	補する
製する	製する
褊す	褊す
褊する	褊する
褒ず	褒ず
西する	西する
要する	要する
覆す	覆す
見ず	見ず
見損ずる	見損ずる
規す	規す
観ずる	観ずる
角す	角す
解する	解する
言ひ屈ず	言ひ屈ず
言ひ期す	言ひ期す
訂する	訂する
討ず	討ず
訓ずる	訓ずる
託する	託する
記する	記する
訳する	訳する
註する	註する
証する	証する
評する	評する
詠ず	詠ず
詠ずる	詠ずる
詣す	詣す
詮ずる	詮ずる
誅する	誅する
誦す	誦す
誦する	誦する
誦ず	誦ず
読損ずる	読損ずる
課する	課する
調ず	調ず
談ずる	談ずる
請ず	請ず
請ずる	請ずる
諒する	諒する
論ずる	論ずる
諜す	諜す
諜する	諜する
諳んずる	諳んずる
諷する	諷する
諾する	諾する
謁す	謁す
謁する	謁する
謗ず	謗ず
講ずる	講ずる
謝する	謝する
謫す	謫す
議する	議する
護す	護す
讃する	讃する
讒する	讒する
貢す	貢す
貢する	貢する
貧する	貧する
貪ず	貪ず
貶する	貶する
貼する	貼する
賀す	賀す
賀する	賀する
賃する	賃する
資する	資する
賊する	賊する
賛する	賛する
賞する	賞する
賦する	賦する
賭す	賭す
賭する	賭する
賽す	賽す
賽する	賽する
贄す	贄す
贅する	贅する
踞す	踞す
踞する	踞する
転ずる	転ずる
軽んず	軽んず
軽んずる	軽んずる
輔す	輔す
輸する	輸する
辞する	辞する
辨ずる	辨ずる
辯ずる	辯ずる
通ずる	通ずる
逞しくする	逞しくする
逞しゅうする	逞しゅうする
進ずる	進ずる
逸す	逸す
逸する	逸する
遇す	遇す
遇する	遇する
遍す	遍す
達する	達する
遣り損ずる	遣り損ずる
適する	適する
選する	選する
配する	配する
醵す	醵す
釈す	釈す
釈する	釈する
重くす	重くす
重んず	重んず
重んずる	重んずる
鈍する	鈍する
鈐す	鈐す
鈔する	鈔する
鉗する	鉗する
銘す	銘す
銘する	銘する
銘ずる	銘ずる
銷する	銷する
錮す	錮す
録する	録する
鎮ずる	鎮ずる
鑑する	鑑する
長ずる	長ずる
関する	関する
閲す	閲す
閲する	閲する
附する	附する
降す	降す
陣す	陣す
陣する	陣する
除する	除する
陪す	陪す
陪する	陪する
陳ずる	陳ずる
陵ず	陵ず
際する	際する
隣する	隣する
隷する	隷する
難ずる	難ずる
難みす	難みす
難んずる	難んずる
非す	非す
面する	面する
鞠する	鞠する
音する	音する
頌する	頌する
領する	領する
領ず	領ず
題する	題する
類いする	類いする
類する	類する
食する	食する
飯する	飯する
飰する	飰する
養ず	養ず
餞する	餞する
餬する	餬する
饗す	饗す
饗する	饗する
饗へす	饗へす
馘す	馘す
馳せ参ずる	馳せ参ずる
駁する	駁する
駕する	駕する
騎す	騎す
験する	験する
験ず	験ず
高ずる	高ずる
鬱する	鬱する
魅する	魅する
黙す	黙す
黙する	黙する
黥す	黥す
鼓する	鼓する
𠮟する	𠮟する
